功能比一般小灵通多许多，不可许多人不懂得用。电话本容量，短信信箱容量，通话记录等比一般小灵通手机多许多。还有很多小功能，比如群发短信，外键拒接，计算器，记事本。。。关键是信号好又稳定，这只小灵通是我用的最长时间的一只，用得很顺手了，现在还不舍得换。我还喜欢那外屏的形状，比较特别。呵呵!	p
有时候爱死机，外屏有问题，很烦	n
外观正面太空银与水晶蓝相搭配，很时尚手机结合硬朗与温柔外表，绝对很男人冷光的外屏设计，强光下也可清晰显示电话簿一键查询设计，很方便。短信加密功能，电话有来电防火墙，双保险关机还可显示时钟，这个设计很方便也很贴心	p
拿着太厚重，一点不小巧.说话声音质量不好，按键也不好用，不能下载铃声，用来用去只是那几个，虽说铃声还算不错，但是总听也会腻	n
1、V81外型棱角分明而略带圆润，造型比较正统。没有外屏，翻盖上方是一个七彩信号灯，可进入菜单对其进行设置；握在手中质感较佳。应该说V81是一款针对男性用户的小灵通。2、V81采用了32和弦的铃声，音量有四级可调，铃音清脆悦耳，穿透力较强，在嘈杂的营业厅能很清楚地听到，一改中兴小灵通铃声小的通病。3、V81的闹钟功能很齐全，可以设定多个闹铃。	p
一次我正在通话中,说的正热闹,突然短信振铃,差点把自己吓死,以为漏电,大叫一声,还吓旁边人一跳,尴尬死了,各位机友,请大家也注意别再出现这种状况,还有,这机子拍照功能还真是差点,相片感觉很粗糙,传到电脑上感觉稍微好点,跟价格不配哦	n
我也摔过N次，强，居然没出现任何问题，捡起来照样使没问题，	p
开机慢，要等会才能用。屏幕的背景灯时间为什么不能调节？5秒钟就关掉了，太短了，不过省电倒是真的，呵呵。16和弦铃声感觉一般，可选的铃声也一般，要是能下载就好了！	n
705用了一段时间，摔过N次，强，居然没出现任何问题，捡起来照样使没问题，这让我没想到的，还能上网，这个价位这个质量可以了。输入法呢，一定要把联想关了，还是很快的，用习惯了，发短信会很快。通话质量不错，声音清晰，这机子不错	p
我觉得还是A96好。造型上，A810肯定远不如A96的；手感上，A96比A810设计合理多啦，手感很好；功能上，A96比A810全多啦，比如GPRS上网，短信防火墙等等。	p
我的机子现在的状况是收发消息就会常常会死机，然后就是每次死机就会没有信号，需要关机后重启。最烦的的时候要想成功发送消息就要开关机N次！再有，只要打电话就不能查名片夹，这机子的转轴声音也很大，而且有越来越大的趋势	n
信号不好,只要偏一点的地方,比如室内,就信号接收不好	n
彩屏、动听的16和弦，且可以上网，支持下载（5首歌）；大容量电话簿（300X3）分组、来电头像、字母查询；多组闹铃（开机状态），且可以写入提示内容，相当于日程表；短消息密码；呼叫限制；黑名单等。性价比不错。	p
信号好！从没掉过线！待机时间长！薄电4天左右！厚电一周左右！可以照相！支持彩E可以通过彩E收发邮件！还可以把自己喜欢的图片以附件的形式通过电子邮件发送到手机！	p
银色的外观显的很时尚，做工也过关，感觉挺结实的！彩屏颜色很柔和，图像清晰！32和弦的铃声也挺好听！来电七彩指示灯特别漂亮！待机时间就算全天开机也能用将近一个星期！比很多手机的待机时间都长！	p
1、搭载GPS卫星定位系统；2、独特、便捷的待机画面；3、机身体积相对小巧；4、支持廉价且通用性极佳的SD存储卡，并支持热插拔。	p
1、外观的确不错；2、输姓名的时候把名字里常用字放前面，比较为人着想。因为我的卡补回来号码全没了，100多个重新输过，体会比较深刻；3、声音不错；4、键盘设计的不错，按起来舒服。	p
一、优点：1、屏幕颜色鲜艳2、声音大，像个塑料扬声器一样，我的手机一响，住我楼下的同事都听得到（），听筒声音还非得调小点，否则的话可以把你的耳朵震麻。3、质感不错4、除了屏幕以外，其它地方还真不沾灰（我上课的时候经常用粘满粉笔灰的手去拿，咦！真是奇怪，捣鼓两下，这灰就不见了）所以半年了，机身还干干净净的，虽然我用的机器是银色。5、键盘好使，手感好，布局不错，还蓝色背光呢（自豪ing）6、质量过硬，耐摔(摔过n次都没什么问题)，基本上没有什么故障发生，我的手机进过一次水，我用电吹风一吹，一切正常7、有两个较为搞笑的游戏，尤其是那个足球，每踢并赢，在禁区踢倒人都没事。基本上可以满足你的成就感！8、内置了不少动感十足的铃声，连“来来，我是一个菠菜”、“妈妈，接电话呀”、鸟叫以及破车发动的声音都有9、有个什么个人生物钟的东西，可以画出你和朋友的体力、智力、情感的曲线，我一看，还蛮准，这就知道什么时候不适合和女朋友吵架，什么时候可以打得过女朋友。10、可以自编铃声，还合弦呢！还五线谱呢！像我这么有音乐细胞的人，用它就创作出了合弦版的《两只老虎》、《东方红》、《红豆》、ext。拿出去炫耀一下，不错不错。	p
在同一地点，有时候，信号格满有时候又一格没有，不是很稳定。手写笔是塑料做成的，很难看。手写笔把握度不好掌握，而且在显示屏上划来划去，很容易损坏显示屏，一般情况下，我不用手写，因为心疼那块屏幕！没有下载功能！无关机闹钟功能！	n
处处都很差的，信号，反正是说不清楚了喽。	n
质量不好，用了半年不到屏幕烧了，而且容易破，我的朋友也和我一样屏幕破了，而且修修贵的要命，一共要1000多。	n
四月份买的手机，至九月份这当中的几个月我的手机有一个月在保修处。	n
色彩较好！！待机尚可！与同价格机器比，优势明显！	p
E88在尺寸上的确略比普通的PPC功能的手机小了许多。117×67×23mm的体积可以让我很轻松的拿在手中。机身采用人体工程学原理设计，让人拿着时间久了也不会感觉疲劳，触控笔的握感也相当舒适，才用了遥杆式的导航键，使用方便。机身下方是SD/MMC的插槽，让用户可以对内存进行无限量的扩展，名副其实的PPC啊！机身30万相素的镜头可以拍摄最大为640×480相素的照片，支持保存为JPG和BMP两种主流图片格式。红外端口可以让用户可以将手机中的电话本与电脑的OUTLOOK同步备分，这样就可以方便的保存下电话本不会丢失了。	p
外观不好看，显得有些笨！铃声调到最高时，有失真现象！内屏材质为CSTN，不如主流的TFT效果好！WAP支持版本为1.2.1，我以前用的那款支持的是2.0,确实没2.0版本的功能丰富！话机短信息容量少，只有50条！	n
这机子的键盘设计真有个性，分三列排，上下键点缀在其中，刚刚用的时候还真是不适应，因为键盘是分开的，所以发信息的时候手指总有按错，漏按的情况，总之啦，挺费劲的，铃声方面，还行，有时候会有杂音，功能方面打打电话，发发信息，我也够用了，但是这机子不能群发的，刚开始没在意，但是没这功能还真是不行，唉	n
不支持短信群发；阅读速度慢就不说了，在我用到第四个月时，发短信时经常死机重启；第五个月时，打电话时经常死机重启！常常是打个三分钟的电话，它要死机三，四次！	n
外观上的红色，有些假。手机速度慢，在进行菜单功能切换时，总要等一小会儿！短信输起来也不方便：按键手感不好，键位有些发硬，短信输入时间长了，手指尖有点痛！屏幕有时会黑屏！	n
待机时间短，声音小	n
铃声还凑和；屏幕平常还能看清上面的文字，但不细致;显示图片时，有时感到色彩不真实；而且一到强光下，屏幕明显模糊了。键盘手感不好！内置的游戏跟本没意思，还不如把内存腾出来，加大短信存储量！机身容量也十分小，能下载的东西没多少。	n
1、整个机器看起来非常漂亮，特别是夜里，黑色的外屏，兰色的数字真的给人很好的印象，不愧是夜光精灵！机身小巧，很适合女孩子使用！男的，拿着稍微显得小了一点！2、内屏是 65K 色的，色彩还原也比较真实，用机器里自带的图片看起来很舒服。3、闹钟功能丰富，支持关机闹钟，可以设置周一至周五、周六和周日，还有定时提醒，不过不能自已设置时间，有10分钟、30分钟、 1小时和3小时四个选项。 	p
外观时尚经典，几年前我就钟情于此机，但当时三四千元的价让我感到力不从心，但它的靓影一直在我心中。现在看到它都跌到这个价位了，正好我也要换手机，所以毫不犹豫地买下了。可用了几天后才发现功能太差了。	p
短信息容量小，只有15条，平常不得不删除一些有用的短信息！不支持短信群发功能！内置游戏没有意思！没有最常用的GPRS功能！没有JAVA或数据传真功能，无法下载和传输任何音乐和游戏！	n
它的外型我之所以非常喜欢（准确来说是喜欢的不得了）这一款手机，就是因为它的别致的造型！最主要的原因就是因为它的外型设计实在是太不一般啦！它外型方方正正，像一个“火柴盒”似的，棱角分明的外型设计、银白色的金属质感、内置式的天线，无一不流露出其造型设计的与众不同！键盘，在键盘的设计，GM800可谓是狠下了一番功夫，它的键盘设计很有特色。它的功能键区和数字键区是明显的被区分开了，同数字键相比，它的功能键区是处于银白色的区域内，这使得使用的时候很容易将他们区分开来，不致混淆！为了体现这两个键区设计的不同之处，设计人员又对键盘做了进一步的设计，使得它们的区别更加明显：那就是功能键区的蓝色背景灯要比数字键区的蓝色背景灯要亮得多、深得多啦！	p
垃圾产品，才用了3个月就出现蓝屏，板子还有问题，请不要买	n
键盘反应很慢，外壳也很软	n
键盘不好用啊，发短信我按快一点键盘的反应就跟不上了，唉，这个严重影响到了我的心情，郁闷。	n
样子喜欢，呵呵，漂亮时尚，屏也大，数字键小小的，发短信容易错字，我正在努力适应中，通话效果还行，常用送的耳机，总听人说辐射的事情，怕怕了，呵呵	p
看这里大家都谈到刷机的话题比较多,我也谈些点个人观点：   ( 1 ) 刷机到底有没有害处?刷机软件升级理解为,和电脑重新安装操作系统差不多吧,从WIN95、98到XP，漏洞少了、系统易用、稳定性都有很大提高。手机的软件升级也可以减少和修正一些BUG、稳定、运行速度加快等。   ( 2 ) A665刷A668的升级软件，个人理解为电脑32位硬件要安装64位操作系统一样，硬件不支持，假如能安装也不能使用。    所以在硬件不改变,只是软件版本升级的情况下,A665增加一些功能如;菜单、快进、快退、保存、支持MP3以外其他更多音乐格式、更稳定少死机这些是做得到的。照相机的清晰度、MP3的音质想有多大的改善是不太现实的。就拿MP3来说，在MP3的放大电路方面，多数用户要求音量要大，但是本机喇叭直径又很小，音量大低音强，播放MP3时喇叭传出的声音肯定是破响，也非常耗电。所以在电路硬件上就得衰减低音，提升高音，现在反过来要通过软件提升低音，可谓收效甚微，很难。所以版本升级改变的也不会太明显。	p
上次修了还不到3天时间又出理同一问题，时好时坏，到现在根本就不能用，详细请看上遍。大前天去维修点，检查出是受潮了，晕，新手机怎么会受潮呢？再说我又没有淋湿接电话时手又不会湿，维修人员说要清洗一下，80元，……还是三包？？？，什么售手服务，就算是三包之内也要检说是人为造成的，现在又坏了，我等会要还去国美换手机。……垃圾	n
多媒体功能还是比较强的，只是这些功能一用感觉超费电啊，一块电池如果听MP3，又电话，又短信，不到2天就要充电了，总充电会不会对电池寿命有影响？希望电池能用长时间一点	n
机身造型出色多媒体能力强支持TF卡拖影现象明显传输方式单一字体过小夏新M650除了能够播放MP3音乐之外，还支持MPEG4、3GP格式影片播放，由于采用了独立的AMR9处理器，让其对于动态视频处理能力有所增强，在播放过程中画面相当流畅。	p
不知道怎么说一个字好	p
一向以为滑盖机是三星的专利，现在看到这款夏新手机后，还知道我们国产也有滑盖机，而且质量不比别人差；搭配的2.0寸QVGA彩屏效果特别出色，无论是浏览图片，还是看移动视频都觉得效果不错，画面惊喜度很高；而且附带的200万像素摄像头，让我走到哪里就拍哪里，而且支持存储卡扩容，再也不用担心拍照收到容量的限制啦，可玩性相当高；另外支持丰富的JAVA程序，让这款手机可以满足我悠闲时打发时间的要求	p
经常收不到短信息	n
支持键盘、鼠标、优盘、移动硬盘，支持播放格式多，音质不错，总之这还算功能非常强大的一款手机。	p
样子挺大方的，拿在手上有点分量。手写功能方便，手写笔也好用（比较长，好拿），只是识别差点，不过可以外接键盘来用，比较方便。	p
PDA功能齐备丰富、屏幕显示效果出色、外观成熟尊贵。	p
货烂！售后服务差得很！大家别上当哦！	n
30万像素CCD摄像头，成像效果清晰。耳机接口与数据线接口各自独立分开，分别通过不同接口连接，并为其提供了保护盖进行防护。上下滑盖可滑动至任意位置，滑动过程流畅。铃声表现层次感突出，对爆音控制十分好。	p
1.屏幕显示效果好！2.2英寸的超大26万色TFT屏加入了CGS的独门技术，显示效果一流，分辨率达到QVGA标准（240×320），很少有机型可与之媲美。2.拍照效果出色。别看GX32的摄像头是100万像素的，但效果十分不错，但色彩还原的真实度和对焦的精确性远非一般百万像素拍照手机可比。配备闪光灯以及微距模式，即使是某些200万像素的手机也要甘拜下风。3.数字键位置宽大，黄绿色背景灯在黑暗处看起来既清晰又漂亮。4.MP3播放功能简单易用。	p
这台手机太强大了!	p
对于死机，我是痛不欲生啊，发短信，看图片等的时候多按几次中间的那个摇感键就死机，或者是随便震动大一点就死机，这机子真是把死机表现得淋漓尽致了！再是电池，反正我只要一闲下来都是让手机冲着电的，在学校天天冲，时时冲还过得去，一出去，简直就是拿一个模版机！像素太低，现在１０００左右的３０Ｗ的多了是了	n
外型没的说,该有的功能都有了,屏幕很清晰.买时售货员说是30W,可我看应该是10W,不过说实在的,手机上的摄象头玩玩就可以了.电池用两天(我从不关机).红外很方便,话音质量满意,别的网友说的死机问题从没遇到.总之你买了决不会后悔的.	p
1，待机时间超短，充电一晚上，可以用一个白天，周而复始。2，左右上下按钮坏掉，只可往下按，为查一个信息运动量不少。3，随机就配一块电池，还得随机充电，不方便。4，照片分辨率低。....太多了说不清了。	n
功能全,内存大,价优物美.	p
1.机身采用了优质磨砂材料，不易沾上油渍或指印； 2.屏幕表现力出色； 3.铃声音量较大； 4.拍摄效果清晰度高, 没有明显的噪点； 5.支持红外、JAVA、WAP和GPRS； 	p
待机太短，反应太慢，死机太易，录音太吵，空隙太大，信号太小，游戏太辍，无聊太多，壳材太逊，卡位太紧，护镜太空，国产太流，广告太假，用时太烦，售后太夸。	n
1.机身做工出色。2.整体软件的响应速度较快。3.拍摄功能强大，支持短片拍摄，且成像效果不错。4.支持大约两个多小时的录音。5.电池待机时间比较长。	p
存储电话本1000组.方便比同类照相效果好.可靠性非常的高.	p
操作起来不是很方便,有时很慢,不小心会把所有的文件删除掉,外壳太松,信号不是很好,有时联键,不太好用.	n
个人认为本机还不如CX65来的好看。	n
功能非常强大,因为使用的是Symbian操作系统,可以安装第三方软件,实现更多的功能,尤其是NOKIAQD手机上的游戏很多都可以直接安装在此机上!安装软件时游戏直接安装到MMC上就行了,内存里尽量不要安装程序,这样如果机器系统有问题,只要格式化原机,原来安装的软件不会丢失,能继续使用,但有个别软件可能不行!	p
爱死机,容易进灰尘,后盖松动,	n
S65经常会死机；电池续航能力太差，仅一天；反应比较慢；搜索网络的能力不太好，一旦没信号，再也找不到网络了，要关机再开才行；	n
1 屏幕不行，色彩颗粒感蛮强，但毕竟在这个价位都这样。由于屏幕拱起，屏贴帖不好，总有气泡。2 铃声表现一般，有破音的现象，听的让人闹心，不过音量小点就好点了。3 电话薄功能不行，容量小，没快速查找，没名片式，只好张三1 张三2 ，不爽！真的很不爽。4 菜单操作 进游戏 上网 ，速度较慢。5 没自动锁键盘。由于之前用的是N3108，有这功能，当换这机子后，很不适应，总忘了去手工锁键盘。6 待机状态下，4位方向键上键竟然没用，浪费！7 电池外形构造不好，有一小卡，如果再买一电池，经常换电池的话，估计很容易损坏。	n
缘分啊，啥也别说了，同样都身为手机大腕（索爱T628、摩托E398和西门子CX65），做手机的差距咋就这么大聂？？？ 本人进行了逐一比较，综合其功能、性价比和外观时尚程度，我最终选择了CX65~~~~~还是那句话-什么也别说了，如果你也看中我说的以上3的方面的特点，那就别徘徊不定了~~我的兄弟姐妹们~~	p
性价比很差，外观粗糙，屏幕虽大但颗粒感浓重，32和弦还比不上3*16和弦的铃声，bug也有不少。挺贵的价格居然标配一电一冲，连数据线光盘等都没有，和同档次的机型相比性价比太低了！	n
我买的时候是2800买的，怎么贵的机却不支持JAVA，而且外屏的拍摄效果很糟糕，什么都看不见！！机身很厚！！	n
铃声清晰，屏幕清晰	p
比较灵巧，比较经，很好看。功能也比较齐全。	p
手机用了六个月，壳裂了三次，换了三次，现在早就报废，不知去向	n
1、内屏的亮度不能手动调整的，这个太不人性化了，希望能用改进2、数据线的同步功能做的不错，不过是串口，要是能换成usb的就好了3、再说背景图，要是文件稍大一点，界面操作就会变的很慢，不好不好，要知道好图都小不了4、手写笔每天都要拿出放进多次，现在感觉松了很多，有时候会掉出来的5、还是笔的问题，用着很不顺手，手写识别也不够准确	n
手写识别还可以	p
总是死机	n
铃声超大，电池待机长，可达7天，用了十个月，没坏过	p
用了9个月以后开机也经常死机,不知道是电池还是手机有问题按键也不行,音质也不好,现在要到经销商去看看怎么回事	n
1、用耳机简直不能正常通话回音太大简直太烂货在任意价格的情况下买的它本公司新原装机总能应该正常通话吧但是天阔就达不到2、用免提在信号弱在地方不能正常通话3、照像效果不好4、不能发彩信5、售后服务太差我买机的第二天去换机他们说是耳机的问题一换就是一个星期以后去取，保换十五天就去掉一半的时间了，我一个星期以后去取，用耳机还是不能正常通话，我说换机，他们再啊试几天看，到第十一天去换的时候说现在没有这种机了，再过两天去，到第十四天到的时候说，这种机是这样的，没得换，又说我把机又搞花了，最主要的是说这种机是这样的，没得换，大家说这是什么样的售后服务。我真后悔怎么就选中了这种手机	n
不行老是自动关机	n
MP3不错,我喜欢,价位还可以接受。	p
功能齐全，性价比很高。用了不到四个月，一点问题都没有！	p
价格便宜,有MP3就这两点让我看中了你.	p
1、功能比较多，款式不错2、播放MP3音质不错3、待机时间在同种功能的机子中算比较长的，3天以上4、配置齐全（双电双充一耳机、数据线、光盘）5、做工精致，保留了南韩机器的风格	p
功能挺多。手感不错。	p
 从索爱W810C一上市，偶就一直关注着这部机子。无他，就是偶对这部机子一见钟情！酷酷的黑色机身，还有对WALKMAM的信赖！使得偶不得不爱啊！正所谓前几金难买心头好啊！但是这部机刚上市时虚高的价格，使得偶不得不望而却步！终于半年过去了，W810C的价格也降到了一个比较合理的价位了。偶终于下定决心出手了。看着W810C终于落入偶手，心理那个痛快啊！好了，不说废话了，现在谈谈偶这两天的使用上的一些心得吧！    该机的优点前面很多大侠都有过评论，其他的就不说了现在说说偶感觉到的优点吧！    1、发短信时是用大字体，看起来很舒服，也减少了打错字的几率。（偶以前用的那部摩托E680I的发短信时简直就是浪费了那么大的屏幕，字体就那么小不点，让人看起来不舒服。）    2、不知道大家发现了没有，W810C也有低电的警告灯，就是在红外端口处，每当电池没电时就会一闪一闪的。这样就不用打开屏幕也知道手机快没电了。这样设计比较人性话。	p
20号收到蓝色论坛代购寄来的W810i。用了1天半，把用后感说一下。对新购机的起一个参考作用。　　 　　1.我选择的是黑色。黑色比较时候男人，连主题一起用黑色，非常酷！后面的摄像头没有机械基构，镜头露再外面，比较容易弄脏。不过，镜头这点脏不会构成取景模糊的。再所说屏幕，这个810的屏还是比较满意的。对比度和亮度笔W800有提高。色彩非常艳丽！只是分辨率只有176*220，仔细看还是看得出像素点。但是，不过已经很满意了(W900的屏幕亮度和对比度不够)。没用过240*320分辨率手机的用户都会满意的。还有一个就是亮度感应，非常好用，外面光线暗了键盘等酒会自动亮起来，反之就暗下去。很好！！　　2.系统软件。W810的软件大量采用了W900的要素。比如把资源管理器区分为手机和存储卡两部分、软件在线升级、快门声音选择等等，这些都是出自W900手笔。软件速度很快，没有滞后现象。得心应手，连开车发短消息都很方便了。还有，特别是W810的主题模式，随着9格菜单的变换，手机都会震动一下。很爽啊！　　3.铃声。W810的喇叭其实和W900、W800都是一样的。后面的三个孔只是装饰而已。中频高的铃声MP3都会出现暴音。只要开小半格音量就没事了。所以再选用铃声的时候，本人建议选用品质较好的MIDI铃声，因为索爱的喇叭对高音的还原非常好。个人认为虽然是单喇叭，但是铃声效果比三星D608要好。特别是音量。很有力度。　　4.摄像头和W800 W900一模一样。就不说了。　　5.MP3播放效果。和W800 W900一模一样。没什么改进。只是把耳机和转接线换成了黑色而已。不过我要说的是，对我这样的音乐发烧友来说，索爱现在walkman系列的入耳式耳机还是比较低档的。顶多是一个索尼EX51的料。高音和低频处理的都不是很好。换用SONY EX71后，效果马上体现出来了，特别是手动EQ以后。高音马上通透、低音软绵绵的，很是舒服！但是，这个MP3播放功能和专业MP3还是有区别的，至少我能听出来。　　6.关于智能手机和非智能手机的个人想法。智能手机非常好，可以装这个装那个，加蓝芽GPS还可以实现导航什么的。不过，象我这样手机玩多了，反而不喜欢智能手机了。因为每次都是买来新手机以后兴致很高，软N多的软件。觉得真不错啊，可时间长了，就不去摆弄那些玩意儿了。烦都烦死了，没兴趣去弄那些软件了。其实弄来弄去无非是QQ啊，字典啊，导航啊，游戏啊。智能手机相对来讲体积较大，夏天走路塞口袋不是很舒服。后来想想也就觉得没用了，又要开始换新手机啦 	p
其一：音乐播放键图标，做工相当精致。其二：数字键盘区设计合理，键盘操作简单，易用。其三：待机方面，一般为四天左右，这个数字比较令人满意了。其四：数据传输速度相当可观，速率满理想的。	p
索爱机的屏就是清得不得了,我用过几个最名牌的手机中,它是最清的.音乐和录音效果特好.真是音乐手机.此外我喜欢它的手机绳往下挂,这样不影响打电话和拍照.设计不错.几科学的.	p
屏幕大了0.1英寸（K750/W800为1.8英寸）；容量大了2GB（W800最大支持2GB记忆棒）；耳机档次更高（现在的耳塞品质与SONY E51素质类似）；扬声器声响更大（3个孔音量更大但其中一个没声音，是装饰）；屏幕下的五维按键比以前的拨杆更稳固牢靠；	p
   拍照功能十分强劲，便于我平时记录生活，完全足够了～而且，各种型号，同档次200w像素的拍照手机，不管什么牌子，绝对不可能撼动750c“光影捕手”的称号，这个，也是各个论坛都能找到的评测阿对比的。   铃声表现也很巴适，有几首我十分喜欢的，来电铃声，足以强劲，在公车上也拉风的很哦～有网友反映铃声小，可能和mp3原文件有关吧。视频声音有点小，恩，这个有点。    游戏，自然不用说了，下了很多很多，仙剑可玩性也很高，超级玛利更是以前小霸王的翻版，呵呵`~~~    待机时间我也比较满意的，平日玩手机还是很多，有时传照片插了数据线，就充电一会儿，所以，买了三个多月，充电器充的次数可能小于5次。	p
DC功能强过WALKMEM,但是有哪位在玩的知道拍摄时滞是否明显	p
我用了两个星期竟然死了死次机。都是在我一边听音乐一边在玩其他功能死的。有时候反应速度很慢。	n
让人不会用,数据线是摆设连接就充电,真是活见鬼!	n
但意就太貴了呀	n
功能强好看	p
200万像素的拍照,26万色的屏幕,但最重要的还是优秀的mp3功能.	p
又发现的缺点：一、将使用数码相机照的相片传到手机后，无法将照片作为背景，容易死机。二、使用一段时间后导航键会出现毛病。	n
音质，画质，拍照都很强，经常拿来在朋友前炫耀~~~嘿嘿嘿~~~~	p
先来说说小5的优点：1、26万色TFT屏幕表现出众；2、Walkman功能，我想这个不用我多说了，用过的人都深有体会；3、外观时尚，旋转设计；4、铃声出众，不用担心漏接电话，回头率高！5、可更换白色外壳！本人对白色手机有偏爱，之前用过的3个手机摩托V66GPRS、飞利浦330、三星S308都是白色的，这也可以算我选择小5的一个重要原因.	p
我买了两个月,就不能听电话了,我都不知道怎么回事情啊!!!	n
我用了５个月，存在里面的图片就看不到了，又是机器问题！	n
耳机效果只能说一般，音质也就和普通MP3差不多低音很足，只能说凑合了。铃声也我也不觉得跟大多数评测说的一样糟糕，穿透力很强，音质不错，MP3铃声听起来清晰不糊没有很大的杂音。操控上感觉这种旋转的方式有点累，也许才用几天不熟练，索爱的机器感觉打字上没有NOKIA方便，尤其是在中英文切换上，还有键盘布局大了点，手小的人操作会有点累。电池待机觉得还不错，本身电话和短信就不多，不过在上网时曾发现电池的容量显示飘忽不定，一会黄色显示40%，等不上网了，又绿了到50%，有点糊涂。在USB同步时也同时充电很不错，比IPOD好多了	p
前天礼拜六，买了，2300元，全套，（亚太水），型号W550i，估计行货18个月后能降到这个水平。	p
铃音太少了.电池不耐用.销售小姐夸口说待机时间可以达到4天，即使打打电话，发发短信也可以用2～3天弦根本没有40，导航键和电池都不行	n
我于2005.05.01买了一部这样的手机不到两个月不知怎么的没声音了。还有，再过几天，玩游戏好死机，就是说，按什么键都没反映了，晕。只有关机重起才可以，后来又发现了个垃圾缺点，就是设置震动时，别人发了个信息来，一直震个不停，垃圾啊	n
1：有个红外端口这对于低端的产品来说是比较少的啦！不过，一般也不怎么用得到！	p
虽然配备了闪光灯和自拍镜，但可惜的是并没有提供自动聚焦功能和镜头保护盖，而镜头下的扬声器可惜索爱配备的也不是双扬声器；数码镜头部份不支持自动聚焦，为了获得足够的清晰度只能通过小光圈的方式来实现。	n
W800使用了一年多了,感觉非常好,音质效果不用说,通话质量很好，SONY的影像技术更不用怀疑,选W800没错. 	p
优点很多大家都说了,我就不多说了.	p
质量太差了，我买的新机W800I，用了15天就坏了，一开始是一照相就死机。刚修好三天，就又出毛病了，总自动关机，又发回去修了一个多星期，发回来用了两天，又出现开不了机的毛病，什么破烂呀！发回去，维修的人说我传MP3传上病毒了！！真是奇迹了，听个MP3能听出病毒来~！一开始以为水货质量不行，后经自己亲自把首行货维修站的大门~！豁然发现原来大家都一样~！！行货也是维修的人不断~！时而排排长队，大家一起等待。只不过是行货能及时维修而已。哎~！已经买了，十分无奈。	n
1、音乐功能不支持wma格式的音乐文件，太孤傲2、键盘外形有点不人性，单粒键盘尺寸缩小一点，就不会太挤，造成按错健	n
W800使用了大半年,感觉非常好,音质效果不用说,SONY的影像技术更不用怀疑,现在降价非常实惠,欲够的朋友不要犹豫,选者W800没错.	p
W800C太好了功能全	p
显示屏不错，音乐播放很好，电池是索爱的优点。	p
功能齐全！拍照功能好！	p
音乐,屏幕清晰```外观好看``	p
现在才出来,香港早就有了,都过时了,而且好多都是港行货改的在国内卖	n
很新潮,很适合学生,外观好靓	p
成了一个数码相机，不像手机了。功能很全，支持	p
屏超大，颜色超好，看图，打游戏爽死了，另外，这机子功能超强，MP3红外蓝牙俱全，爱玩的朋友可以考虑一下	p
大家的SC3听筒声音都这么小么，在饭店的会场里无法清楚地听到对方的声音，？？调到最大声也没有用处，是不是大家也有同感啊，其他的感觉还不错。	p
老死机，蓝屏，太刺眼了，信号不好，没有扬声器，通话时声音太小，１６和弦，太单调，发短信不方便，不像三星那样没有下一个字．	n
老爱死机，让人着急，有时还得把电池拿下去充电才能再用。我用的6个月竟然死了5次啊，有两次我还白白去维修了呢。屏里爱进脏物。小巧，但也给小偷机会，我的就这样被小便方便了。	n
用了有两个月了，没死过机。	p
有“移动”标志。按键很舒服，很有弹性。蓝色键盘灯散发出来的光线也非常漂亮。摄像头具备补光灯，夜拍时可以好好地利用。它的接口比较多，支持红外、蓝牙；还有USB，和电脑上的USB联上，信息就可以共享了	p
1，屏幕亮度不够，是所有STN屏的缺点。2，只具备16和弦铃声，所以其铃声的表现力算是一般。3，10万像素摄像头对于时下主流的30万象素来说略显淡薄。黑夜当中拍摄效果较差4，显示屏幕偏小5，电话本不支持群删6，续航能力相对不足	n
外壳好看！性能也好	p
翻盖滚轴处用几个月后就要开始脱漆，相当难看。录音只能录十几秒，形同虚设。输入法不是很方便	n
铃声实在太小小小了	n
虽然内置了MP3播放器，但手机内存只有26MB，也没有像VS7那样支持miniSD卡扩展。而在数据连接方式方面则舍弃了蓝牙功能，仅支持红外和USB数据传输。	n
不支持短信息的群发！无红外功能，以前总是用无红下载，缺了这个功能很不方便！内存小，对于拍照手机，照片可是要占许多空间的！音量调至最高会明显失真！动态摄像只有25秒一段，时间过短！手机内置的游戏可玩性不强！	n
1,手机电池用了才半年,不超过两天就要充电了(晚上10点自动关机,早上8点自动开机),太差强人意了吧!2,键盘太小容易打错字和拨错号.3,买来是2980元现在跌到16002460元,太离谱了吧!4,说明书讲的免提功能和录音功能找不到啊!是骗人的吧!	n
1、 松下X300手机最大的买点就要算是它的独特DV概念的外形设计。小巧、精致的机身、配合上87克的机体重量，将“魅影”的设计初衷演绎的更加逼真。2、 X300手机整体线条设计流畅，机体色调搭配在具备市场潮流元素的同时也不失稳重、大气之势。烤漆工艺材质的机体表面也使得整款手机的机体更加的具有优秀的金属质感。3、 松下X300手机选用了65536色的彩色显示屏幕，屏幕分辨率为128×128像素。虽然屏幕的显示面积不是很大，但是其显示效果还是较为令人满意的。屏幕亮度、色彩明暗掌握的都十分的恰当。而且画面清晰、图像细腻。4、 松下X300手机机身的两侧采用了橡胶材质的防滑边框，这样可以进一步的提高手机的防滑能力，使手机的具有了很强的视觉感、增强手机的整体性能。5、 手机左侧设有一个30万像素的数码摄像头，同时设有镜头保护盖，可以更好的起到保护的功效。利用X300的这个数码摄像头，用户就可以拍摄生活中的细节照片或是进行短片的录制了。6、 这款X300 手机支持图片以及手机铃声的下载功能，可以使用户收集更多更好的图片等内容。7、 松下X300内置20首40和弦手机铃声，效果悠扬动听、悦耳清脆。通过机体背面的外置扬声器， 40和弦的手机铃声演绎的更加的真实。8、 自编铃声功能可以带给大家更多的乐趣。用户可以充分的发挥自我的聪明才智，编辑一些属于自己的乐曲，同时利用手机的其他功能还可以是其乐曲演义的更加有乐趣。9、 松下X300手机内部可以存储500组联系人电话号码，同时具备8组热线拨号、电话簿名片式管理功能和电话簿群组设置功能，这样可以更加的便于用户日常对手机电话簿的使用和管理。10、X300手机支持普通短信息和彩信两项功能。手机内部可以存储250短信息，同时具有2564Kb的彩信存储容量。T9信息输入方法，可以使用户更加快速的完成短信息的编辑任务。10个短信息常用短语，可以更加的有助于平时的短信息内容编辑的速度以及更好的节省时间。	p
屏幕大，效果极佳，一键翻盖手感好，支持Java，支持Bluetooth，摄像头支持微距效果，支持500条手机短信存储，有外屏，比较方便	p
外形好看	p
数码相机像数11万也忒低了吧，而且内存也那么一点点不支持JAVA。另一方面就是铃声不怎么好听	n
不支持彩信。不能用耳机。	n
不支持MP3！电话本容量小！短信容量也不大！待机时间比较短！	n
在充电时老是死机，任何按键都无效。机子买回3天就发现死机，来回检测好几次，检测人员才承认机子有问题，1个月内换货遥遥无期，机子广告宣传上有真人来电照片显示，调了半天没有调出来，设置的外屏图片常常会无缘无故的跑到内屏下方，有时内屏字体是颠倒反面的。	n
机子整体感觉还可以，83×45.5×20mm 的三围显得比较小巧秀气，很适合于女生用。 打开翻盖，1.8" 的超大内屏占去了翻盖的大部分面积，本人认为比起一般的128*160像素的手机内屏要大，65K色的屏幕看起来还比较艳丽细腻，由于使用的是STN材质，因此图像看起来没有TFT屏幕那么鲜亮饱和。30万像素的摄像头功能比较齐全，无论是动态还是静态拍摄效果跟其它的30万像素手机没什么差别，在手机上看还比较令人满意。键盘按键手感较好，而且各个按键间隔都比较的大，输入文字不容易按错，操作非常舒服。40和弦铃声听起来还比较清澈、悦耳，但和三星的比还有一定的差距，这不能比啊！通话效果还可以，声音比较洪亮。电池待机时间晚上不关机待机时间应在三天左右。也许是这款机的屏幕休眠模式在发挥作用，在不动任何键的情况下，屏幕始终处于休眠状态，不会显示，非常省电，这是C8090的一大特色。	p
任何你能想到的缺点...1照片那个难看啊...2屏幕在太阳下,什么都看不清,3按键很容易磨损,4而且外观也容易磨坏,5升级后的电话本更是令人喷饭,6按键发短信累死人了,7机子反映超慢,老死机,还搞什么手机病毒8那个什么java,根本玩不了,人家都不支持.9而且没有不能传输文件,不能按数据盘,10文件储存量实际上也就1mb!顶多!11下载的铃声不能重命名12电池不抗用,13玩游戏时,好不容易打了很多分,可是老莫名其妙重新开机	n
没有数据线，内屏颜色应该没有6.5万色，在阳光下就会看不清屏幕显示的内容，通话声音比较小，没有GPRS和计数器！	n
信号有时不太好，售后也不怎么样，不支持彩信和MP3，价位也比较高。	n
无法下载,太差,希望朋友都不要购买	n
屏大，体看起来舒服	p
质量太差,不到一年两块电板都不行了,一接电话就自动关机.当时还在保质期,那儿的工作人员也检查不出什么来,现在过了保质期,坏得更历害,只能当手表用了.而且按键也不灵了,外壳也掉漆.我的天,一年半都还有,我只好换手机了.	n
以前，首信的牌子挺响的，现在好象不行了。不过V859，我还是很喜欢它，它的功能比较接近时尚，双屏了，百万像素拍照摄像头了，还有多种闹钟……	p
没有分组铃声，不能下载，总是死机，总而言之，谁买谁后悔。能不能招回呀？	n
1.屏幕显示效果一般； 2.摄像头不带闪光灯，不支持夜拍； 3.不支持红外和蓝牙，扩展性一般；	n
今天收到手机了，我是通过网站邮购的。我买的是珍珠白的，比网络上的图片要漂亮一些，很喜欢。过程虽然有点漫长，但等待还是值得的！显示屏颜色比我预想的好一些，把对比度调好，还是挺鲜艳的。当然，4096色的STN是没法和三星的TFT真彩相提并论，不是一个档次的不能拿来对比。输入法也还满方便，如果习惯了应该可以更快一些。符号输入也很方便。另外一些功能也不错：英汉汉英词典功能很实用；计算器比较直观也容易使用，有开根号等其他手机计算器所没有的计算内容；闹钟有4个，早上喜欢赖床的JM们不怕错过班车了。	p
来电振铃声音太小	n
1.屏幕显示效果不理想，画面不够细腻！2.通话质量不是很好，声音不是很清晰！3.铃声小，容易错过电话！4.扩展性能一般，不是很理想，读卡速度比较慢！5.总体质量一般，做工质量不够精细！	n
刚刚托朋友搞了一台8390，是国内SED贴牌的，但配置和台湾和港版的有所不同，两电两冲，双头耳机，最为关键的是完全支持简体中文。屏幕的显示质量，可以用无懈可击来表达，无论是色彩还是清晰度均无可挑剔，其次是手机的整体做工，决不输给韩日机器，在接缝等细节部分处理得都不错，MIO越来越有大家风范了，最后需要说的是价格，目前港版的价格约在3000左右，行货也只要3700（我拿的是3700，据说市场上要4000多），如果按3700在这个价格说，应该是物超所值了，总比一些所谓的摄像手机、商务手机要好的多，何况它是一部可以可以RIY的MS Smartphone啊！     	p
手机的铃声象单声，收到来电发出来的声不好听，手机的铃声不知道如何下载，短信群发功能不好用！	n
电话本太烂了，没有联系与添加的项目，手机没有配备数据传真接收的数据线！	n
1、  彩色双屏折叠式手机，77x42.4x23.9mm的三围尺寸，仅重81克，精致小巧，爱不释手。2、拥有双语词典，大容量的英汉\汉英词典随时随地满足用户的需求。3、  短信存储容量超大,最多可存500笔短信.可自创短信文件夹,分类管理,一目了然。4、可以选择7种乐器进行自编铃声，也可以通过数据线进行铃声下载当然利用GPRS也不在话下。	p
机身厚度比较大，拍照的效果也不怎么满意，不支持JAVA、红外和蓝牙。	n
待机时间太短了!!那说明书上都是骗人的	n
外观看上去灰灰的，笨笨的，一点也不漂亮！而且给人臃肿的感觉！双屏手机，但效果不理想，色彩不够真实，文字显示也有毛边！声音不够大！短信容量不大！电池不怎么样！一般一天就要充一次！而且感觉特费电！信号不太好，我这个有段时间死过好几次，去找售后，没法解决！说等上面的意思！拖着拖着没那个精力去和人家理论了！建议大家别买这个机子！	n
1、很喜欢X700的来电防火墙功能，设置好后，对方电话上听到的提示音为：”对不起，您拨打的电话正在通话中“。如果能提示：“对不起，您拨的用户暂时无法接通，或是暂时不在服务区”就爽了。2、提供快速静音模式，只要长按#字键就OK了。	p
铃声效果很普通，和我同事买的那个诺基亚24和弦铃声相差不多！拍摄短片没有声音！机身内存小，而且不支持外接存储卡！无JAVA功能！无MP3功能！	n
1、手写笔不插在机身而单独存放是三星的最大败笔，基本失去手写笔的意义。2、不支持免提扬声器，扬声器的音质较差，声音较小，而且是右边的一个发声，左边的是一个装饰品。3、不支持扩展卡，内存太小。4、不支持联系人姓名声母查找，只支持首字母查找。通话记录中的电话号码不能加入已有电话本的项目中，要么另存一个，要么记住号码再找到电话薄进行修改添加，电话本的使用很不顺手；下载的图片不能用作大头贴。5、不支持数据和立体声音频蓝芽，蓝芽在拨打电话时有时不能自动接听，需人工转换 6、不支持语音指令学习功能，对普通话的要求较高，不适应发音习惯；不支持快捷录音功能。7、下导航健同C健很容易搞错；OK健太小太硬，只能用手指甲使劲按，手感极差，输入几个字就会手疼。8、文件浏览器不支持自动页面适应功能，只是将整个页面缩小，要放大字体同时放大页面，造成不能自动按手机页面浏览。9、无照相闪光灯，关键是少了一个微型手电筒。10、没有比较全面的保密项目，只有的电话拒接只有几个号码，不具备短信防火墙和保密功能是最大的败笔，短信及其他单项的保密已是LG和摩托罗拉的标准菜单	n
触摸屏太差，做工不精致，时常死机，无网络信号后无法自动搜寻网络，不能双模同时待机，充其量是个双卡机	n
很多很多	p
属于小巧可爱型的，携带方便，如果充电正确的话，电池待机时间可达半个月。	p
在我看来除了能打电话,接电话,,好像什么功能都没有,要的话就得出钱	n
但比108多了挂绳孔	p
太多了,前面都有人说过了!	p
输入法不爽，输入标点时，须切换输入法。不支持MP3，拼音时，每选字须按数字1键，进行确认，再进行选字。	n
挺值	p
1、 造型小巧，在X108的基础上进一步减小体积使得C208拥有更加广泛的消费层面；2、 键盘布局合理，C208的键盘设计继承了三星一贯风格，无论从人性化还是手感上来说都算得上一流水平；3、 机身顶部增添了手机挂件孔，很好的弥补了X108在这一点上的缺陷；4、 支持JAVA功能，内置了4款非常精彩的JAVA游戏；5、 电话簿容量达到1000条，并支持名片式存储，在这一点上接近商务机型的水平；6、 待机时间表现不错。	p
很漂亮！！！	p
小巧，适合女孩，像个小玩具一样，手感好	p
 最初一直关注N6270,感觉外型硬朗大方,可惜NOKIA的滑盖做工实在不敢恭维,只好转而关注3*,D808,D528之间犹豫之中,E908、D908相继面市，经过试机，发现漂亮的E908实在太小，握在手里，没有一点质感，于是锁定D908，尽管D908的下巴不是很招我喜欢，但用上去感觉不如D828那样碍事，终于决定拿下，一原电一原充，一配电一座充，数据线、耳机、说明书，呵呵，价格贵了点，2800，喜欢也就值了......拿到D908开始试机，漂亮的外观，超薄的设计（我对超薄实在不敢兴趣，倒是希望机身厚一点，可以提高一下待机时间更为实用，别拿砖拍我啊），无一不体现了3*精湛的工艺。    1、推开滑盖，感觉有些松动，然后再轻轻推一下，便没有了松动的感觉，原来是没滑到位，反复试了几次，推开滑盖的时候，手指稍微用力立即移开，让滑盖自动弹上去就OK了。    2、D908屏幕清晰靓丽，屏幕背景为长城主题界面，可以随时间不同而变换，时间显示为“周二 19 9月”有些别扭，要是“周二 9月19日”会更加符合国人的习惯。设置手机日期和时间时发现，默认时区为伦敦，居然没有北京时区，BS一下程序设计者。好在不影响使用。    3、进入声音设定发现按键音不可设定，在论坛里搜了一下，按照“设定——显示设定——拨号显示——字体类型——改成正常”按键音设置就可用了（日历设置不可用也是同样问题引起），木琴音听起来比较悦耳。    4、进入显示设定，把“文本显示”关闭，待机屏幕上的“中国联通”消失了，爽......    5、电话簿可以分组，不过每组只能20个号码，差强人意，并且不可以设定分组铃声，最郁闷的是电话簿不能按首字母查询了，好象I1版可以解决，期待刷机线ING......	p
1、D908屏幕大些2.1英寸，E908屏幕2英寸，差别不是很大。　　2、D908体形宽大，造型大气比较适合男士使用；E908体形瘦长灵秀，男女适用　　3、D9的操作系统内核是swift，E9是agere，操作系统上看D9的拓展性会好些，可以打补丁使用功能更过完美。　　4、D9摄像头像素： 315万像素 并支持自动变焦，E9摄像头200万像素，没有自动变焦　　5、D908是超薄机身，E908不是，但机身也挺薄。　　6、E908是上盖按键采用时尚触摸键；而D908是普通按键，但实用。　　7、E9有一个独立扬声器，D9都是听筒兼扬声器，两个铃声都不大。　　8、D908支持铃声并振动功能。E908没此功能，只能靠软件为MMF格式铃声加震动。　　总而言之:E9的价格低，因而性价比较高，它主要卖点是：时尚触摸键；　　D9配置略高，但在功能上并没有与众不同的表现，它主卖点是：是315万像素变焦摄像头。	p
钢琴漆，镜面处理，手感好。功能比较全，几个功能键采取感应式设计，较为时尚；200万象素，够用；支持扩展存储卡。	p
这款机子刚入手没多久，也就７２小时吧，下面就来谈谈自己的感受．外观方面：尺寸非常合适，拿在手里感觉非常爽，全机通身上下全是黑色，显得异常的高雅，滑盖也很灵巧，没有网上评论Ｄ８２８那种滑盖还要摩擦到键盘的情况．２.０寸的显示屏幕给人感觉相当的大气．后盖结合也很紧密．触摸键的白色灯和黑色的整机显得非常的协调．这款机子从外观上讲充分显示出了３＊优秀精致的做工．稍微不足的便是众所周知的此机极易沾上指纹．不过贴了张屏幕保护膜后，此问题也得到了缓解．性能方面：此机操作很轻松，快捷键的搭配也合理，可以根据个人需要随意设置．很人性化．支持后台ＭＰ３播放和飞行模式（脱机模式），音质方面是差了点，毕竟只有个扬声器嘛．２００Ｗ象素的摄象头更是一个非常理想的配置，我还有个朋友用的索爱的Ｋ７５０，那机也是２００Ｗ的象素，但两台机子放在一起，就发现我的小９在屏幕分辨上略胜一筹．我估计是屏幕大点的缘故吧．另外在全屏播放录象片段的时候没有发现有些机友所说的三条斜杠．或许这个是版本的原因吧．ＭＰ３的铃声个人觉得还是相当大了，因为我从５２ＳＡＭＳＵＮＧ上找了几首大音量的．至今还没发现过漏接电话．听筒声音也比较大，感觉比我下岗的小６都大．电话薄的功能就显得很不科学了，每个分组只能装２０个联系人．搞的我分成了同事１，同事２．呵呵，查找联系人只要把输入法改成英文字母后也很方便．此机最大的问题便是触摸键太灵敏了，特别是右边的取消键一不注意就容易点到，很不方便，不过我换成了左手操作，呵呵，也克服啦，顺便也把右脑锻炼啦．	p
触摸键太敏感.不好用.	n
外观比较酷，钢琴漆，镜面处理，手感好。功能比较全，几个功能键采取感应式设计，较为时尚；200万象素，够用；支持扩展存储卡。	p
价格便宜。屏幕超大，可显示8行中文！32和弦名符其实。红外接口。支持彩信，可玩性强。	p
1.自动开关机功能。我最喜欢的手机功能，M330居然有，我太兴奋了。设定自动开关机，在一定程度上可以延长手机待机时间，爽。2.红外线功能。M330如此价位的机器，居然有红外，且红外兼容性还不错，可以和部分有红外的手机通过红外传图片（不能传铃声），但通过红外传电脑上的图铃至M330没有任何问题。3.通话计时提示音功能。这个功能很人性化，拿到M330时，进入“通话记录-通话计时-提示设置”，发现只能设置分钟，有些失望。可设置为1分时，发现实际通话时是每到50秒就有提示音（提示音还比较大声），欣喜若狂。（后来看了说明书，知道提示音是在设置分钟数前10秒就发音提示的）4.其他人性化的方面。M330内置了不少实用功能，如录音器（录音最长达120秒）/日历/货币转换，这些功能平时生活中都用得着。M330的背景灯亮度可以调节，屏幕对比度可以调节，让人觉得用起很舒心。M330打游戏和GPRS上网时，屏幕背景灯常亮，很为用户着想。M330的左右功能键可以自己编辑，很方便。	p
上周六,（上海）太平洋数码4F-迪信通,两电两充,耳机,100元短信卡1368大洋!我玩了刚好一个星期，对大M总体感觉尚可，优点如：烤漆色泽优雅，屏幕大而色润，待机图片很有特色，32和弦铃声非常有穿透力等等！	p
我是前天去买了这款手机，拿来摆弄两天后，发现这款机子确实不错她几乎包含了市场上中等机所有的功能，且又是彩屏机。	p
我用了这机子有一段时间了，总体感觉还是不错的，显示上够清晰，但是有一点点的暗，问题不大，功能的设计很不错，人性化设计很到位，优点有不少。	p
不能下载真人真唱，接受文件小，没蓝牙，信号不是很稳定	n
用了一段时间后色彩失真,排线易坏后,导致内屏黑屏!本人非常不支持!	n
色彩明亮，对比度好，通话质量高	p
手感不错~但同事都说手机太大，不适合女孩用，但我觉得很好，拿在手上很有个性~~	p
声音小小毛病不段	n
特别之处就是外屏幕的闪电屏幕	p
听说屏幕叫“闪电屏”！很有兴趣。外观出色，很时尚！百万像素、26万色屏幕、64和弦，挑手机时觉得这些数值都是最好最高的了！色彩清新明快，景物清晰，十分满意！夜间拍出的照片也行了。	p
输入法太慢,拍照反应慢,有许多MP3不能播放,强烈不满:电话本库存不下没有提示,甚至把我所有客户号码,短消息自动清零,因为我没有备份,导致我损失惨重,赔我!	n
做工挺好，拿着也很气派。26万色的彩屏感觉不错，画面柔美细腻，完全没有粗糙的颗粒感。自带的数码相机真不错，支持10倍变焦。照出来的照片效果不错，对各种色彩的还原比较准确，完全没有杂边。都快赶上真正的数码相机了。	p
所有按键经常会神出鬼没的失去功能	n
1.一款典型的女式机，漂亮的墨玉黑色松石蓝和玛瑙红色，并且体积不大，重量不多。正面翻盖镜面设计便让人爱不是释手。确实太漂亮了，偶第一次便看上如此精致的外观了。女式机就是女式机真的同刚刚用过的M65有天壤之别（呵呵，说多了，本来就不一个类型的）2.有64M内存，虽然比起一些支持存储卡扩展的机型在容量上要相差很多，但是比起2000左右的索爱K700C还是要多出将近20M左右的存储空间，况且还能连在电脑上作优盘对于一款千圆左右的机子已经很了不起了！并且支持时下流行的MP3，在播放音乐的时候还可以通过机身左侧的快捷键来调节音量大小！同时可以在翻盖闭合的情况下播放音乐利用外屏滚动播放歌曲歌词。音质同OT756一样注重高音而对低音的播放略显不足。因此MP3播放可以说是这款机子的一大优点！3.支持JAVA程序虽然在现在手机功能大有一统数码天下的时代已经不算得上新奇。	p
感觉蛮好的	p
视频拍摄虽然支持有声视频，而且每段15分钟的时间令人满意，但是清晰度低于拍照的效果，特别是在细节上面，“雪花点”明显增多。M760支持MP3铃声，而且下载方便；加上拍摄照片所占的空间，总感觉内存小，而M520不支持扩展卡，只能事先把存入机身内存的文件先删掉或者传输到电脑上，然后现下载音乐或者折摄，感觉很不方便！	n
1.不支持JAVA、蓝牙和红外； 2.机身做工一般； 3.拍摄效果平平，没有设置自拍镜； 5.短信提示音量较小。	n
信号不是很好，有自动关机的现象！做工不好，感觉翻盖不流畅，转轴处还易积灰，很难清理。拍出的照片不清楚。下载的铃声，无法设置成来电铃声；其中内置的铃声听得时间长就烦了！	n
但是质量不好/维修时间长	n
我比那位11月份花了2300元占了点便宜，我是8月底在大连买的，2080，仅仅是省点而已。这款机子的毛病太多，最要命的就是下载的铃声，不能设成来电铃音。而且之前我的手机还一直打不开彩信，打电话问了客服才说还需要升级。前几天刚升的级，还好是免费。没有数据线，不能和电脑同步，问了一下一条数据线还要280块钱！至于上下盖左右晃、不时自动关机、主页死掉等小毛病我就不多说了。	n
03年1月买的，到目前没出现毛病，质量可靠。可设定开关机时间，还有倒计时闹钟，日程提醒，非常实用。	p
内置数码相机、双彩屏、菜单人性化、体积小巧。	p
 首先是外壳和天线材质很差，一些不小心就会损坏。其次很耗电待机时间短。玲声小在公共汽车上基本听不到。接收信号的灵敏度小在一些楼房内没法通话。想上网下载玲声和画面即没驱动程序又没信号线很麻烦。更可气的是售后差劲（武汉地区）。总之本人买了这款小灵通近四个月后悔无及。	n
音质不错。有语音报时，还有免提功能。手感还行，没有手电筒功能。群发功能不错。短信发完自动回到写短信的原先状态，感觉很好。发送的短信自动存储。这是其它手机的没有的功能。随机带了30张图片。小黑白。感觉不错。	p
待机时间长是这部机子最大的优点，带了手电筒功能，很实用。	p
键盘太小;居然不支持红外线;没有火线口,不即插即用,拿手机到别人处拷文件时,真不好意思叫别人装驱动.让人感觉很不爽.其它品牌手机都有小火线口.就诺记没有.这样的MINI卡的用处大打折扣.	n
5.1在国美购买，上周出现N70无信号，国美维修处还在推责任，以后再也不买诺基亚啦！	n
皮实!手感!大小!都非常好!待机时间也很满意!特别是声音很大!不错!	p
开机反应非常迟钝，电池待电时间也不是很长，不过好象觉得比我那个W800C的待电时间长，内屏虽说是26万色，可看起来不是很清楚，这点不如W800C，键盘太小，连在一起很容易按错键，拨号在屏幕上显示的数字也很小，真不知道带回国后老爸能不能看得见那么小的数字。照片只能横着显示，并且设为壁纸时也是横着的，且只能占屏幕的一小部分，不能覆盖全屏，这是我最不爽的地方，虽说相机相素是200万，就是觉得照出来的效果不如W800C	n
可以对图片（相片）进行编辑，很有趣！（我编辑起来很恶搞的！！！）摄像效果很不错！（注意：是摄像）	p
1.做工很好,后盖的弧度有所增加，更符合人体手型.顶端、背面、底端设计的很有韵味，划盖无论合、起都是非常完美的造型，正面的金属面板，加上小巧的机身,握在手里觉得够踏实，帅气，2.采用Symbian8.0操作系统，熟悉的S60操作界面依旧具有亲和力，九宫格的显示菜单还是那么的人性化。支持主题功能，向下兼容以往所有的主题，因此不必担心界面是否足够的华丽。N70作为升级产品继续保留待机模式快捷方式，当然不习惯的用户也可以将其关闭。五个可自由设置更换的快捷方式在使用上带来很多的便利，让人感到诺基亚更为人性化的一面3.方便的后台运行，可以同时进行听歌上网和QQ聊天,在收听收音机或多媒体时如有来电，手机会自动转换至通话模式，等通话结束后再自动恢复为原来状态4.专门的音乐播放快捷键，N70似乎也要赶一下这个潮流，在键盘右侧增加了一个多媒体键，键盘终于能够左右对称，5.各种声音的设置都是采用情景模式管理，熟悉诺基亚手机的朋友也很容易上手，普通的语音通话、视频通话、短信、邮件等都能设置独立的一种提示音。支持MP3、AAC、RealAudio、WAV、AMR、AMR-WB、AMR-NB、AU、MIDI等格式的铃声。扬声器的音量非常大，即使在比较嘈杂的环境下也不会出现漏接电话的情况。对于声音外放的暴音控制得很到位，穿透力强，如果戴上耳机的话效果更好，立体声十足.完全不亚于一台高档的MP3播放器播放器.，6.汇集了诺基亚N-Series的便捷行动拍摄功能，利用200W画素相机和闪光灯，搭配20倍数位变焦、白平衡、色调调整及多种拍摄场景,再加上26万色高彩萤幕，足以达到一般数码相机的水平。7.透过NokiaXpressTransfer储存解决方案，NokiaN70能将影音资料与个人电脑快速存取。想要马上列印照片，也可透过NokiaXpressPrint快易印，以USB传输线、蓝芽无线及RS-MMC记忆卡等多种方式来列印多媒体资料夹内的影像。8内建NokiaLifeblog「写e生活」软体，让爱玩部落格的人能够透过手机进行图文上传，随时随地享受即拍、即写、即传的网络生活	p
只要你想要的功能，几乎没有达不到的！	p
键盘小不好操作	n
性能一般	n
目前的同级产品中可算性价比最高的!	p
难道这就是中国奸商的经营之道？	n
内存可扩展也许会更好,外观很经典!我觉得应该是一个时代的代表作!	p
使用N73一个多月了，谈谈感受。我的N73是新加坡版的，记得买机那天，早就联系好的卖家先给我一个欧版的，被我坚决推掉，后来到天快黑了他才打电话给我说找到一个亚太版的，呵呵，看来亚太版的比较难找啊。记得第二天我又陪我一个朋友去那家买n72，仍然是只有欧版，无亚太版，n72最终也泡汤了。所以提醒所有准备入手亚太版的老大得多点耐心。    1、外观：    首先需要澄清的是，N73的气质还是继承了N70的大气和力量感，我用的前面银色后面黑紫色，不知道白色的给人感觉如何。从发布到现在一直都有人在议论N73怎么像索爱的风格，如果只看图片的确如此，但是你手上拿着真机也许就不那么说了。背面磨沙处理的材质容易沾上指纹，因为难保手上总有点汗啊什么的，背面得软磨沙质地也比较容易有小的划痕，正面按键银色部分也容易有指纹，只有数字键好一些，当然这些都不是重点。    2、屏幕铃声：    屏幕绝对一流，直板机少有的2.4寸大屏幕，表现力强悍就不提了。铃声就众说纷纭了，我觉得还是很不错了，跟具体使用格式和音乐质量有关系，声音大是肯定的。3D铃声试了两下没搞出什么明堂，用MP3剪切软件搞了几个喜欢的歌的音乐部分做铃声，超酷（自我感觉）。对于壁纸不能全屏我觉得还是有道理的，因为屏幕的最上面部分试显示电量、信号、时间等等的，如果壁纸延伸到这个区域恐怕也会被这些东西遮住影响整体感，同时如果偏好全屏也可以自己做主题。随便搞比例为正方形的图片，分辨率不限制，就可以将图片部分全屏为壁纸了。  3、MP3效果及拍照效果：    个人感觉MP3效果中规中矩，效果也不能算差，但是也无出彩之处，搞了个耳机转接头插上我的森海塞尔MX400（这个耳机并不是很好）感觉效果还不如原装的耳机好，所以如果想换耳机来提高音质，则耳机得慎重考虑了。拍照效果就不多说了，白天不错，晚间很差，和网上得一些评测很吻合。	p
期待 N73 许久，终于下手在网上买了一部银灰色的。用了三天，说说它的优缺点。以前我用过诺基亚 6100 、摩托罗拉 A768 和多普达 830 ，所谓优缺点，是比较后的体会。 优点： 1 、拍照功能强大，可以满足一般照像的需要，出差时不需要另外再带一部 DC 了。 2 、立体声音乐播放效果非常棒！远远超过我用过的其它手机。 3 、电话网络信号强，通话效果好。 4 、 26 万色彩屏清晰艳丽，电影播放流畅，图片浏览方便。 5 、使用软件与 PC 连接可方便进行程序安装、文件管理、音乐下载等操作。 6 、上网比较方便，但速度不快。 还有一些优点，这里不再细说。 	p
 本人购机已经有一个星期了，在这段时间里，对其的优缺点也有了个初步的感想，现记录如下。 优点：         1 ，整体造型不错，大气、稳重，比较适合男性朋友使用。     2 ，和诺基亚以前的 4096 色的 CSTN 的屏幕相比，屏幕质量有了个飞跃，达到了时下手机的主流配置。     3 ，闹铃有了很大的改善，不但支持关机闹钟，还支持了重复闹铃，对上班族来说就可以不用天天调闹钟了。     4 ，时钟在更换电池的情况下，不需要开机是再次设定时间了。     5 ，录音功能在通话过程中很有作用。     6 ， 16 和弦的铃声穿透力很强，调到最大也基本无破音现象。 	p
外形简约稳重；做工不错，用料扎实，被我不慎摔过N次了，还进过水，照样很“健康”，按键也很有手感；待机时间一般情况下也有三四天左右，在彩屏手机里算不错了。	p
我买了一年还没到就出现了好多问题，真气人。1、每次电一用完都要重新设时钟、日期，很麻烦。2、电剩一点点时，闹钟不行，我好几次都因此而上班迟到了。3、太容易进灰尘了。4、最近发现电池用完了充电后再开机连原先设置的屏保图案也变掉了。	n
通讯录有声控标签使用很方便，红外线接受也很快，图片效果不错。键盘使用很舒服。	p
这款机买了很长时间了，最让我开心的就是它的输入法联想功能。很合理、很丰富，还有词组联想，有时候还能联想出相应的标点符号，省了我不少时间呢。而且红外线兼容性也很好，传输速度很快的	p
存储太小，配存储卡跟机子不兼容反映慢	n
1、由于键盘的设计，某些键按起来不是很方便。2、摄像头的镜头没有保护，裸露在外，如果镜头表面不小心留下划痕，会影响到拍照的效果。3、手机稍微大了点，重了点，携带不是特别方便。4、机身附带的音箱效果不是很好，音量较大时会有一些杂音。5、电池的使用时间稍微有点短，只能待机48小时左右。6、光线条件稍差的环境里，照片的效果会明显变差，虽然增加了一个夜间拍摄功能，但拍摄出来的照片效果仍然不是很理想，有明显的色斑。7、4倍变焦功能并不是很实用，由于是数码变焦，倍数变大之后图象质量下降得比较明显。	n
出色的另类设计；百万像素的数码相机；配有RS-MMC存储卡扩展槽。	p
音质和画面还行,有封闭用户组功能,却不能封闭来电!	p
1.屏幕大.色彩清晰2.滑盖手机。3.外观还可以。	p
还不错，512卡，双电，2700元	p
很多：我的机器出现了三次‘个别人’才能出现的问题——开机便因为短信功能而死机……然后就属于瘫痪状态,其次，普遍的问题：1.滑盖不稳定，易松动,2.反映很慢……,3.电池难以负荷如此大的屏幕；一天一冲,4.一键通快捷设置不科学，打开滑盖之时，容易触碰。5.输入法不够方便，还不如6020等老款机型	n
    使用N721个月整，好处就不说了，地球人都知道，认为需要改进的地方如下……    1、屏幕和键盘容易进灰，虽然这是直板机的通病，但72似乎更明显一些，或者是因为72是我用的第一款直板机（以前都是翻盖的），所以感觉特别明显；    2、自带闹钟功能太少，不支持多日闹钟，必须下载第三方软件，但是目前好像真的没有特别合适的闹钟，或多或少都存在缺陷；    3、后滑盖容易松，一按上去还嘎吱嘎吱响，有些提心吊胆。。。    4、摄像时，1个G的卡比较卡，虽然播放时不卡，但还是有点不爽。。。    5、电池续航能力似乎弱了点，也就2到3天；    6、短信提示不重复，就是说，如果来短信了，它只提示一次，我以前的波导V70是如果你没看，它就每隔2分钟提醒一次，这个功能N72没有，实在说不过去；    7、背景灯的自动熄灭时间太长，还不能调整。。。    8、键盘锁不尽如人意，也得通过第三方软件；    9、通话声音比较小，用扬声器话质不好；    10、原配的HS－31耳塞没法调整音量；    11、每次把卡取出后，主题会自动变成自带默认主题，这个比较麻烦；    12、后滑盖由于中间部位有突起，容易磨花（贴块透明胶或者小饰品可以解决）    13、照相时从拍照到成像的时间长了点，慢了0.5秒多点吧，以前的LG8280时即时成像的；    14、电话号码查看不方便，比如你的朋友“小王”几分钟前给你来过电话，现在你想通过通讯记录中的“已接电话”查询他的号码，就无法直接查询，必须是选择拨打，趁那1秒钟左右的时间记下号码，然后赶紧按掉，很麻烦；    15、名片查询比较弱智，只能通过名字查询，竟然不能通过电话号码查询？！    就想到这么多，其他的还有待补充，新手言论，纯属个人意见，并非恶意中伤，希望大家多担待。^_^	n
手机造型非常不错，简直让人眼前一亮。背后的雕花很大方，而且漂亮。200万摄像满足一般需要，功能强大。商务感不是那么强，非常适合。	p
这里就说几点缺点了1\内存太小了,不支持卡,无法接受的了2\拍照效果比较差地,可以拍一些字来看效果,3\CSTN屏,效果不好,4\由于内存原因,游戏,MP3都有了一定的限制同学在用,说两句	n
待机太短了吧哪有三四天呀我的夜里关了,电话也不多才三天,别胡说呀	n
我的显示屏有时变色，待机时间较短，不能传送数据。	n
信号不太好。蓝牙有杂音。有时无来电显示。PC传输开关设计不好。体重也超标了点。	n
价格太高，不是一般人用得起。如果5000元以下就差不多。	n
    1.我用了一个月了，手机没进过灰。曾经以为摄像头进灰，后来才发现是内部的元件，不是灰尘。    2.屏幕是不是斜的，没法测。我的屏保是专用的，但是贴斜了，没办法。不过很好用，沾指纹用纸巾一擦，干干净净什么也没有。    3.在英文状态下，进如短信就是中文编辑，很爽哦。好多诺基亚在英文模式下，都不能切换中文，不知道为什么，摩托就可以的。朋友经常借我手机玩，每次都要改成中文页面，害的我虚荣心都得不到满足。哎！    4.听原装耳机听mp3比较费电，我换了个音频转换器，用的森海耳机，可以用很长时间。    5.拍视频短片，拍的次数多了，会死机，郁闷。最近在换主题时，偶尔会出现白屏。选主题尽量选反映快的。    6.发彩信有些图片发不出去，不知道为什么。    7.后盖有点松，要注意，不要经常用手去按。有时候换电池，不小心会把插sim卡的金属卡带起来，要留心。	n
1、 屏幕够大，买手机时营业员拿一款三*的说是2.12寸屏幕，可是我看着33的屏幕比3*的那个大2、 显示特细腻，清晰，看习惯了33的屏幕，再看我以前用的机子，简直无法入眼，感觉就像当初黑白换彩屏一样3、 通话质量不错，声音洪亮，感觉像音响发出来的声音4、 外观好，容易一见钟情，手感也好，搞得今天女朋友非要拿走给朋友炫5、 操作简单，反映速度也快	p
1.屏幕，采用的是6.5万色的STN，由于点距小，所以表现相当出色，非常细腻，亮度也不错，白天在外面依然看得很清楚。因为下雨所以没有在太阳下看。2.铃声，采用的是40和铉，声音挺大，在人多的地方和车上也可以听的到。4.外屏，屏幕不大，但可以显示时间，日期，信号，电磁容量。来电时可以完全显示号码。并且有2个外屏游戏。蓝色背景灯。5.功能，在待机图片里有动画和平面图和时间图，效果都不错，大概有10来张。铃声有多种选折，且效果都不错，重点是够响哦，大概有30首左右。菜单方面挺人性化，功能也比较齐全。6.速度，这点很总要，看过大显3100速度超慢，这款表现还不错，处理的挺快。没有停滞现象。	p
刚刚用了不到一个月，拍照就不正常了，总有雪花点，该调的都调了还是不行，现在又添了新毛病，时不时的还会白屏	n
可以拍照。信号相当不错。铃声的效果有三星手机的味道，还算中听	p
1、初次见v36的感觉是薄而平，厚度大概有1cm吧 这在直板机中目前已将算是最薄的，手感挺舒服，样子和755差不多，屏幕大，为了突出机器的薄键盘整体是平的，但按起来不肉，不涩，很顺畅。2、65536的彩屏确实很清晰，声音 铃声都很大，内置了二首原唱歌曲及经典的世界名曲，没有破音很醇厚。3、FM有些手机上有，比较人性化的功能，有些手机设置频道时很不方便，需要搜索，在保存，现在简单了，除了有手动搜索外，还有自动搜索，各各频道全部拿下，送的原装耳机也了得，超重低音，震撼你的耳膜，尽情去HI-FI吧。	p
感觉这机子通话回音比较严重，以为是网的问题，换到屋外还是这样，而且充电时间超长，每次充都要1整天24小时，搞的充电器很烫，电池也很烫，感觉这样有问题，电话客服那边，说是要升级软件才行，还有外屏按不亮的，要打开盖再合上，这样太麻烦，准备去客服一起解决。	n
v798是老妈给的，嘿嘿，这里面的英汉词典我很喜欢，等车，没事的时候都能拿出来看，目前我上高中，里面的程度相当于4级水平，每天看一点，还是很有帮助的，也喜欢拿它当手电用，以前没注意过这个功能，一次下晚自习楼道里很黑，灯也坏掉了，才想起这个能当手电，挺亮的不错	p
1、S282没有无线下载，这样可以说浪费了它的好的显示效和铃声效果。显示也不能说一点问题没有，它还是有很明显的颗粒感。2、S282没有数据线，IP拨号形同虚设根本没有什么用处。容量很小，不能在卡上存短信，而且如果不把以前满的短信删除，以后发来的短信就收不到，让人觉得很不方便。3、S282的外屏是单色的，不过可以随机选定颜色的，颜色都不是很艳丽的，看上去过于死板缺乏生机。4、S282的壁纸和屏保太少了。5、S282的输入很麻烦不如T9的方便，拼音很难输入，要多次选定才有结果。	n
1.外屏文字显示不够清晰； 2.做工一般； 3.按键手感一般，灵敏度不够； 4.内屏图像显示不太清晰； 5.铃声有明显的破音现象，不支持铃声下载； 6.不支持WAP、JAVA、GPRS，红外；	n
短信没有彩信功能！无法群发短信！还有，电话薄十分不好用，不实用，没有办法分组和自定义！	n
能保障我发出去的信息对方安全收到。	p
不支持GPRS和图片下载！按键相当“个性”，小得象“豆子”，输起来太别扭了！显示屏也小。还有，电池容量小，两、三天就要充满电。还有“发射键”也小。菜单切换速度不快。	n
显示屏十分清晰！拍照时，启动速度还可以！可以手写输入文字！	p
今天刚买的，正品行货，一切都还好！	p
待机时间短，死机，开机速度慢，有时找不见存储卡，MP3音乐文件经常出现损坏。	n
数字按键太紧凑，没有空隙，手感不爽。反应实在太慢.内存小的可怜，32MB,还谈什么娱乐。	n
MP3效果好，	p
e398视频不能放，售后说是软件版本的事，已有好多用户放映了	n
谁说MP3声音不好了，你下个加洲旅馆看看多清澈，下个你的眼神听听多动人，在手机里绝对是极品了，你不能拿它和CD相比。而且图象异常清晰，尤其把电脑连上可以当MODEM用，太适合我这样在寝室用GPRS包月笔记本上网的学生了，就这个就能值500元的PC卡，就2300这样就不错了。图片和铃声都可以自己做又好有省钱。	p
相比索爱同端手机T618 T628却缺少红外线，而且蓝牙连接繁琐（输和入有两个程序）。导航键设计为凸起，设计不人性，有时手指会产生酸痛感（特别是在玩游戏时），而索爱以上两款就不会。程序反映缓慢，这个相信使用的朋友都会发现，发短信的时候几乎要等一秒多才能让程序反应出打的字词。自带游戏少，做为娱乐手机这点有些让我想不通，（随机带的游戏几乎是SB游戏）还需自己下载。同样的NOKIA3220自带三款游戏的基础上还有让用户免费下载本型号游戏的服务。机身容易进尘土。在同端手机都具有名片储存功能的时候，E398却还是以前的单人存储。DC照出的画面略显红色，且闪光灯还需手动开启，过于麻烦。	n
1  华而不实2　操作系统的响应一如即往的慢3　放出的MP3音质实在是...用“音乐”形容简直是玷污了“MP3”这个词，或许只能说“它内置的喇叭能放出声音”，而且又有着极大的杂音，不仔细听的话，根本听不出它播放的是什么曲子。4 屏幕的响应速度实在是...用它来播放影像文件，感觉像是在看幻灯片，再配合那惨不忍听的声音，呵呵，圆满了...5　电老虎，电板一天一换6 输入法比E365的还差，切换英文和数字的操作太烦琐。MOTO特有的笔画输入法更是难以忍受...对习惯打NOKIA、SAMSUMG、SIEMENS等笔划输入法的朋友来就是一场噩梦。	n
同志们,买这款手机时一定要慎重,我元旦在公主坟中复电讯刚买一部,昨日系统就出故障了.另外该手机闹钟闹铃时你不关闭,它一直持续响铃.由于使用时间短,其他缺点还没发现.	n
最近购了此机用了几天感觉不错，优点就不在这说了，对于待机本人用原电充足后平均一天发８条信接打电话１２分钟待机约能维持4-5天。	p
以前没用过手机，但是这款太让我爱不释手了，功能很好，现在配件就差耳机没弄到了，原装的太贵了，用转接头接的话只有一边响，其他都很满意．数据线是同用的，只要买２.５毫米的ＵＳＢ都可以用，很方便，而且存储卡价格也很合适，推荐各位买这款机子，我买的时候１７６０一电一冲，不知道大家的价格是多少？现在就是不懂怎么弄电子书来看，那位大虾知道的，请一定要告诉小弟啊	p
待机时间超短的``根本没有说明册上说的200-350小时```稍微用点24小时都不到```这个是怎么回事	n
电池容量偏小，续航能力一般；30万像素的拍照功能跟不上潮流。	n
10.15入手，1050＝1电+1充+1数据线+1耳机（不能确认是否原装）+512TF卡+1大陆加印的说明书黑款，沃达丰定制版    之前阿尔卡特的OT535用了将近三年，所以下面的体验很多会和小5的使用感受做对比    首先第一眼感觉机型较长也较厚，宽度适宜，还是比较适合男生的手形使用的。拿到手先试试摇杆，感觉还不错力度适中，比OT535的摇杆稍紧一些（原因是535的摇杆比较松，几乎不用什么力摇）但770的摇杆太光滑有时候摇着会滑。770的其他按键的分布是紧凑密集形的，中间几乎没有什么间隙，这点我感觉不是很好，因为原先535的按键一个是一个、间隔较大分得很清楚不会出现按一个键而牵及其他按键的情况（用535发短信真的是神速）。另外770的按键凸起太明显，如果指甲长一点按上去容易打滑，535的按键平整。还有就是770的照相机的快捷键在机子的右侧，这样的设计在单手操作时候由于键对着手心所以是很难按下去的。可能是因为使用习惯的原因所以觉得就按键方面而言770只能算是一般。    性能方面的确不错，除了开游戏或其他JAVA程序以外其他反应速度都很快，使用起来比较流畅。但是要说说软件和手机本身的设置的问题（我刷的是小碳的F1P），第一个让我不太能够接受的是作为一款直板机770没有设置自动锁键盘的功能只能手动加锁，还有一个就是在省电模式下屏幕全黑后就什么都没有了，没有像其他很多机型一样在黑屏状态下保留时间的显示，这个也是很不方便的一点。以上这两点不知道通过将来刷新的包来完善，如果不能就太遗憾了    再说一下屏幕，在看惯了同学的L7和E1的26W色屏幕后再来看E770的6w屏还是有一定落差的，不像有些网友所说的“只是厂家的文字游戏，没有多大区别”。当然不能算差，只是和自己相像的有些差距罢了    最后不能不说一下E770的电池盖，自从在店里装上电池后到现在只卸下来过一次。不知道其他的机子是怎样的，反正我的这部后盖真的不是一般的紧啊！而且没有按钮没有任何防滑的设计，上次拆下来不知道花了多大的劲。	p
信号不好	n
668元国美刚买的,不错600条电话,160条信息,有收音机,能上网	p
1.回车键和发送键连在一起，容易误操作　　2.待机时不显示时间，只有再按一下才显示　　3.外放比想象的差多了，为最大的不足，看样子是2个音箱，实际只有一个　　4.移动的定制的，有移动的标记和快捷键　　5.添加播放列表很麻烦。（本人不觉的）　　6.目前软件不稳定，或多或少造成使用的麻烦。　　附加 1.我使用半个月 白屏两次　死机 一般是拨对方号码没嘟嘟声 然后按挂机健没反应 按任何键都没反应四五次了　按c上面的那个取消按钮有时可以挂机　　2.键盘锁住了不像诺基亚或者摩托的一些型号只有按特定的按钮才能亮屏幕　 e2 是按什么键都会亮 所以经常不小心按倒按键使得屏幕点亮很浪费电池　　3.法短消息不能像其他手机或者型号编辑完短信按发送键后他会出现号码或者短信菜单让你确认　而是直接发送　 再加上他的发送键和回车键近很容易没写任何内容就不小心按了发送键或者导航键而发送了空白消息　　5.c键在很多时候不代表推出　要用选项键来取消发送　如：短信到了草稿箱 短消息不能马上用删除 而是要选取消　　6.个人觉得他要是有摩托的其他系列的 复制 剪切 粘贴功能就好了　很方便的把多条短消息　放在一起转发人家	n
很早就在想换手机，一直在W810C 3250 和E2之间徘徊，后来还是选择了E2。比较喜欢E2的外型。我一向不用日货的，3250又太厚了，夏天不爽。关于买机器，很多朋友都在观望，在等水机上市。我一国美的朋友告诉我，国美要包销我也就不等了，急啊，真的很想早点拿到真机。最后以2190的价格拿到了黑色的E2，还送了N多东西，一堆礼品。很多朋友说在国美买的时候没有礼品，那是你没给他要，你只问有没有礼品送，她销售小姐肯定告诉你没，其实她们都自己私藏了，你给她要，她要不送，送的不多，你就不交钱。说了那么多话，来点主题，黑色E2，机身的烤漆和造型拿到手里感觉很不错，也没传言中那么爱留指纹。就是有点担心哪个大大的标准插孔会进灰。机器反映也还可以，不算慢。我拿到手的是01.29P的。论坛上有人说这个版本不老美，我也不是很懂，也没敢刷，还是等等吧，等大家都拿了，刷的人多了在说。按键硬度和摇杆的感应我觉的还可以，入手不是很生硬。就是键盘有点小了，对于手大点的人来说可能会按错键。照相机130万的，配上MOTO 的屏幕，表现力不是一般的好。之前用过好几个130万的，3230，D508， 感觉还是E2的好点。音质，这是E2最大的亮点了，我拿到手后，朋友们谁见谁说音质棒，就只用标配的耳机都很震撼，如果在专门配个耳机就没的说了。	p
我恋上她啦：时尚！小巧！智能！毫不犹豫，用她替代了我的的MOTOE680I！但我很快从最初的欣喜跌落到低谷！ 1、电池不够耐用，接打1小时电话只能待机一天。 2、MOTOROLA 明 2006年主打手机，内存太小只有几M。真小气！3、智能手机，买它就是为了方便好玩，可是软件太少！智能有什么用？4、200万照相机的效果差！怀疑是插值，和其他的手机（200）比真是……5、好看是好看就是怕用手去摸它。为什么？ 不是怕把她拿坏，是只要用手去拿它，它到处都是我的手印！6、这样的高端手机用了一段时间就会划伤！不是人为！ 是只要一用就会划。 是因为打电话的时间把手机上盖打开，上盖和下壳的接点没有胶垫缓冲，硬碰硬造成！7、连个挂东西的地都没有！8、40和弦的铃声音量不是很大。简直就象病猫叫！  我用软件把MP3的声音放大在把它传到A1200里，结果还是大不了多少。 9、屏保不可以用动态屏保。10、 A1200的屏倒还可以！真想把好看的图片当屏保多看一哈！可是在待机的时间怎么也看不了图片的全部！A1200的卖点就是  《 明  》 ，明就是透明嘛！  在待机的时间透过上盖可以看到好看的图片那是多么爽的事情！ 如果想看时间，星期，和功能时，在按一下键盘就可以了！ 就是这点小事情MOTOROLA 都做不好！	n
优点大家都说了。现在3400的价格还是比较值得购买的	p
老死机,什么破机子	n
用了5个月，外观不用说，NO.1!功能方面能出其右者很少，除了LINUX软件少，还没找到对应版本的GPS软件，其他还没找到什么毛病，上网速度飞快，除了不支持框架结构，网页的兼容性很好。标配和赠送的电池都可以支撑8～10个小时的连续上网，如果不经常启动显示屏，连续常规工作2天没有问题。总之，前面网友提到的问题，在我这里基本都没有遇到，千里马还需配伯乐，不是什么阿猫阿狗都配使用智能手机的。	p
触摸键失灵，老死机，买了一个半月就修两次了，我在天津路维修点已经遇到五个人是同样的毛病了，天哪，4000元啊，太冤了	n
和E680I比，它的翻盖设计，能很好地保护手写的大屏幕。黑色的很内敛，没有E680I的那么招摇。伤心啊，我的E680I就这么被抢了，还过A1200是不错，还有大礼包，送了好多东西，有蓝牙耳机，三个电池，还有车载充电器，还有一个最大的惊喜，就是还送了一个mircosd卡和转接的SD卡。虽说只有100多元钱，可真是让人感到什么是体贴了。	p
1.高硬度的塑料翻盖不仅具备较佳的耐磨性，对“脆弱”的触摸屏也起了很好的保护作用	p
1）外观新颖2）拥有强大的多媒体功能和卓越的性能，同时将电池的消耗减到最小，方便了更多的用户3)这款手机的重量只有95克左右,轻巧方便4)铃声音质表现较佳，声音层次清晰，即使开到最大声也没有爆音	p
1、优雅华丽的外观，透明的水晶外屏设计，既突显档次，又不失时尚！2、特有的名片红外扫描功能，给商务人士带来了极大的便利！3、柯达移动功能，更把智能手机带给人类的便捷性体现的淋漓尽致！以上三点是其他现有销售机型所不具备的功能，应该可以称之为优点	p
后盖非常难开,容易死机,我3天就拿去换,换后又是死机.连换2次都是相同问题,而且MOTO的售后服务也是差到了极点,汗颜!我直接退机,哈哈	n
刚买了一周，感觉好可以	p
1该机键盘钮质量极差，购买20天就磨损了，而且不管保修。2该机器的录音功能比较烦琐在这我给大家介绍下电录音有两种方法。一是在不打开翻盖的情况下，在通话的过程中按一下照相/录音的钮即可录音，要停止录音时再按一下，通话的内容就记录下来了。二是在打开翻盖的情况下，按一下照相/录音的钮即可录音。如果不是在通话中，打开翻盖后按那个按纽的话就会启动照相机。	n
我的2电2充带耳机和数据线、光盘，和诺基亚的那些小朋友的玩具相比功能太舒服了，适合商务人士使用，功能强大，可以当半个笔记本电脑用了，方便。	p
做工粗糙，1.键盘漆掉落严重。2.上下盖缝隙越来越大。3.电池太马，正好半年就鼓了起来，使接触问题导致经常关机4.功能太简单，内存太小，读SIM卡也费力些	n
做工粗糙，我的机了用了不到一个月，漆面脱落，按键上的漆就裂开了，一片片的掉，电池只能用半年多一点就不能用了，正好过保修，软件系统不太稳定，有时接不通，售后总是推责任，总说是人为使用不当啦，网络原因啦之类的。	n
（1）按键不舒服，特别是处在边缘的四个健13*#越是中间的键越舒服。（2）制作上和国外大厂毕竟还有差距，上下两片弥合的不够紧；而且LCD指示灯闪亮的时候明显没有处在正中间。（虽然对我没啥影响，因为我不开那个哈哈）；还有就是那个OK按钮也没有方正，稍稍有点往右倾斜。（虽然不明显，也不只我说的这些是不是普遍现象）。有人提到，电池盖弥合不紧或者耳机插不进去，本人的机子倒没这些问题。看来还是个例。但从这些个例中也可见Lenovo手机的做工..........（3）铃声虽然号称40和铉，但明显没有我以前的32和铉的samsung手机好。高音太尖，低音力度也不够。反正听惯samsung手机铃声的朋友对这个肯定会有点不满的。（4）导航键设计得不太好，有点往里面凹进去，这样按起来不顺。	n
打电话对方有回音，手机电池松，估计设急有问题；听筒听电话后耳朵像针扎（不知道什么原因），自动挂机，键盘硬的像石头，功能简单的像弱智，更可气的是售后服务，把所有问题都会归结为网络原因......	n
机身大小适中，男士用手感很好，电池也还不错，我这几天天天玩游戏，拍照，能用3、4天。	p
好的就不说了，上面几位都说了	p
没有蓝牙，没有收音，另外，天线是折叠式的，如果天线折起，手机功能就会自动关闭，只保留掌上电脑的功能。用户可以通过手动设置强制在折叠天线状态下打开手机功能，不过信号会大打折扣！	n
我是12月30号买的,用了大约25天有一个键上的字已经掉了.去修还没的修..	n
能听mp3	p
机身漆面质量不高，整机塑料感非常明显。手感生硬，导航键采用了拨杆设计，硬度较高而且十分尖锐，操作起来非常别扭。数字键区更是小到不能再小......	n
1，速度极慢。比我两年前用的名人慢很多很多！删除全部200条短信居然用了1分钟，恐怖！2，不方便使用，界面不友好。连接各项目的排序匪夷所思，缺乏常理，要很长时间才能掌握。发短信的时候选不同的用户很不好用，尤其是用来保存电话本的软件，其不易使用更是超乎想象。建议联想少投点广告，多投点钱在优质开发工程师上。3，傻大。4，售后差。400电话不受理售后，北京售后电话的人不了解新机型，问题要两天才给解答，谁等得了！！！差极了，气愤！！！	n
信号有时不稳定！无电话薄分组功能；无电话薄项目，查找联系人十分不方便！和弦铃声小，只有四和弦！内屏颜色为单色！无数据传真接收功能；无下载功能！不支持短信群发功能！无自动开关机功能！	n
不能发短信，不能拼中文	n
没什么新意思，显得创新不足，更另人郁闷的是，这款机器的扩展性为0，即不能下载图片，也没有红外功能，实在是显得土里土气。不过好在采用的是40和旋的铃声效果还算说的过去。	n
有多种外观可供选择：红、银、绿、蓝，挑了半天，还是选择了红色，整个机身全是红色，感觉十分抢眼！铃声和显示屏效果也还行。300组电话薄和100条短信也够平常用了。支持WAP上网。内置移动QQ功能。待机时间还可以！	p
1、按键稍嫌费力，发了几条短信，手指就累了。2、输入法不如t9好用，是ezi输入法，汉字难以选定，顺序安排不合理。3、科建主页称标配有数据线和光盘，买的时候却告知没有。须自己去买。4、打了6分钟电话，手机开始发热。听筒声音有点破，不知是不是线路问题。	n
样子不好看！有些呆板。没有GPRS功能！而且铃声不好听，想下都不能通过GPRS下。待机时间短，商家只配给了一块电池！	n
1.外屏256色，内屏面积很大，显示效果出色； 2.支持FM收音、一键上网，还支持最新的EMS5.0功能； 3.电话簿储存量大； 4.铃声效果不错，还专为短消息配置10首铃声； 5.支持关机闹钟。2000元左右的代价就能得到彩色屏幕、GPRS、多媒体信息以及蓝牙功能，再多掏一点就有外置摄像头可玩，夫复何求？ 	p
如标题所述。质量还不错，没在维修上出现问题	p
这机子不能上网下载铃声和图片，只能用数据线传，不方便哦。上GPRS不稳定总掉呢。机身设计也不够紧凑。铃声不好听，效果也很差。屏幕一般吧，但是外屏的面板很容易被划伤。	n
外观不够时尚，看上去不象一个两千多元的手机；而且也不够苗条。铃声偏小，在热闹的地方经常听不到来电声音，很耽误事！拍出的照片有些模糊！在电话薄里给联系人添加的信息太少，只有三个。机身无短信内存！使用USB数据线传输图片时，速度太慢！	n
总体上不错，相当满意。	p
1.屏幕比较清晰鲜艳.2.DV摄像功能 ,可以把拍摄的片段发到电脑中保存.3.拍照相当清晰,感觉不象是手机拍出来的.4.键盘设计挺不错的,手感很好,按键比较大,按起来特方便.	p
用了一些日子了，最近这机子出现怪事，我如果只开振动不要铃声的话，在设置中选正常或会议状态的时候振动都不振？！但是如果先听了一段铃声再设振动的话，就能正常使用，晕，以前都不知道，试过N次才知道。还有我的595的电池板越来越松了，用着用着总是出现”请检查sim卡“的字样，郁闷啊~~	n
1.机身设有来电彩灯，非常动感眩目 .2.外屏不是彩屏而是兰+黄双色屏幕，滚动显示出来的时间很有个性,显示很清晰,就是稍微小点.3.支持WAP和GPRS.4.电量低会有人声提示,挺逗的.	p
我是2004年6月份购买的科健k699,使用时间不长，经常死机，修了两次，2005年6月，经销商给换了一块新，用了不到7天，频频掉线，售后服务困难，要求根据手机三包规定退货，但潍坊三联称科健公司已经倒闭了，拒不退货。据我观察我们山东潍坊市场上已经基本上看不见科健地踪影了，不知是何原因？	n
第一，键盘质量问题严重！！！我2004年10月27日购买了该机型，使用不到1个月，1、2、3、5、6、9六个键就一团模糊！！！第二，待机时间基本上在4天左右，绝对难以超过一周；第三，电话本超级垃圾！！！经常自动删减电话记录或者自动复制电话记录！！！这一点让我觉得超级不爽！！！第四，我用到半年的时候，也就是在2005年4月份的时候，手机不断发生黑屏，需要不断重启。后来我去科健售后服务部找维修人员，这才发现科健售后已经人去楼空，找到销售部门，才了解到科健手机已经宣告破产！！！	n
因为本人的短信量较大，使用这个机子发现它的键盘的反应太慢，我又是急性子，就觉得不太满意，建议玩短信的朋友不要选择它。使用了k388一段时间之后，我发现它有很多的问题，键盘的漆质量不好，非常容易磨损，现在我的手机才使用几个月，外观很新，但打开后，键盘的状况吓死人。还有，这机子的电话本不知道怎么回事，自从上次从手机复制到sim卡，再复制回来之后，手机自己就开始自做主张，每次开机，都会消失几个名单，或重复几个名单，我快被气死了，现在我每天还得随身带着电话本，不知道这手机的电话簿是不是用来做装饰的。	n
1、键盘非常不耐磨损，我买了一部K388，用了两个月，键盘就在正常使用的情况下开始变黑，现在几乎看不清键盘了。2、刚刚买回来的手机，就发现日期自动回零，只好到商店更换了，现在仍然有这种现象，换电池的时间如果长了，或者因没有电自动关机了，时间还是回零。3、现在用了5个月了，面板出现明显的松动。4、待机时间没有宣传的那么多，大打折扣。5、在使用过程中，经常出现死机，尤其是发信息时，正在编辑的时候，出现自动退出现象，有时候还无缘无故地收不到信息，关机后重开机，就好了，太烦人。	n
常坏,我怀疑是水货机子,动不动就死机,真拿它没办法.	n
1、电池待机时间真的短到无法接受，我的一般正常的情况下，玩玩摄像，发发短信，打打电话，就必须每天换电池!康佳当时是以全球最薄的拍照手机为卖点来推这款机器的，但是我却万万没有想到它是以牺牲待机时间为代价的！2、内存太小是个不争的事实，功能如此强的手机竟然只有600K内存可以使用的，又不支持外增内存，插SD/MMC等。铃声和图片大部分都是垃圾，又占了手机好多内存，内置的、不喜欢的铃图又删不掉，无法释放有限的内存。3、速度慢，尤其是在短信多的情况下，打开速度难以忍受。动态摄像更是慢的惊人！4、存在太多的bug，几乎我认识的用a08的朋友不同程度上都出现过诸如黑屏、无故自动关机的令人恼火的事！5、所谓影像方面可能没康佳吹的那么好，号称四倍变焦，但是只有在静态来电大头贴可以扩展到4倍，其他竟然只有1倍和两倍，2x和3x找不到，而且除了一倍外，其他惨不忍睹！像素方面，也言过其实，在太阳下几乎什么都看不到!	n
世界上最差的售后服务，刚买了坏了也不给修好！	p
C916的风格我很喜欢，外形简单干净，没有过多的修饰，功能方面也比较实用，虽然没有摄像头，但是个人认为手机上的摄像头做的再好也没有数码相机效果好，呵呵，可能有点武断，但是专还是很重要的。价格定的比较合理，这也是我选它的原因	p
感觉通话质量还有待改近，电话接通后，杂音比较严重，对方听不清我讲的话，要连续讲几次才能讲明白，总搞的很尴尬，我认为作为手机，主要功能就是通电话，所以希望厂家能把通话质量搞上去，谢谢	n
待机时间太短,下载歌曲必须先转换格式太麻烦,拍照效果差,拍的照片不能倒到电脑上去!	n
喜欢这个机型，在柜台中一眼就看到这只了，能放MP3和拍短片功能，我想要的都有了，嘿嘿，但是没有外接卡卡的，内存又不大，唉~~	p
内存太小，128K也就照个墙纸大小的，想放大的地方不够；不支持java下载，也对，这么小的内存下了东西也没地方放，电池用不住，电量不足的提示音还过一会就叫一下，烦人	n
S800造型是典型滑盖手机造型，外型细部都显得非常顺滑。按键部分布局非常的清晰，按键手感很好，在配合蓝色背景灯光设计，朴实简洁。屏幕区按键区的外部造型非常相似，在手机滑盖关闭的状态下两个部分浑然一体，紧密结合。	p
外形不错!	p
唉，不能信手机上的摄像头的，说的挺神呼，可是实际用起来也没感觉特别清楚啊，光线弱一点那片子就没法看了，还有这只机子看着费劲，字体有点小，这个不应该啊	n
可以录音六分钟。也好操作，可以当一个录音笔用了。	p
照相清晰,音质很好	p
除了待机时间短，其他都不错	p
我用过你们的手机还不错加油	p
5.电话本的备份我在KZ690里还发现了一项挺实用的功能，那就是电话本的备份。它既支持将SIM卡上的电话本全部复制到手机上，也可以从手机上全复制回SIM卡上，这样无论是手机坏掉还是送去维修，只要把电话复制到手机卡上就行了。6.其他功能也很实用KZ690的闹钟功能也很实用，除了可以分别设定三个闹钟以外，还可以让它分别按一次、每天、双休日、工作日（就是周一到周五）为周期进行报时。再有就是比较常用的计算器和万年历功能，虽然他们没有什么过人之处，不过做为这么一部低端手机，能做到这些我已经很满意了。	p
电池质量不好，我才买半年，现在电池只用得到半天了，刚买时可以用2－3天，晕晕...	n
键盘看不清,摄像时间不够100秒钟,只有15秒钟.	n
质量太差，我用了也就三个月屏幕就不显了，气死我了，被售货员害死了	n
性能太差劲，用半年换三个主板厂家连个正规维修单子都不给。真是垃圾产品，天时达508，奉劝各位千万不要买啊谁用谁知道	n
浏览网页时，N90没有太大提升，这么强的手机却采用着和6630一样的CPU。使得N90虽然有大屏幕的支持但是系统速度方面的因素直接影响了浏览网页的速度，虽然支持MP3/AAC到3GPP、RM等格式.也能设置横向全屏，但是和6681 6680比起来并没有太大的提高；在续航能力方面让人有些不满意。200W摄像头和2.1寸26W色的屏幕居然是由760毫安容量的BL-5B电池支持的，几乎用不到一天就要冲电。	n
功能强大，手感很好，外观大方，适合男人。	p
外观小巧，简洁，没有一点多余的感觉，具有一定的特色，是一款不错的手机，是民族品牌的骄傲！！	p
操作比较直观，手写识别率比国外品牌好，音质不错	p
我刚刚买了一台，就发现有一个毛病。机器开关时，放出的音乐非常的难听，有巨大的嗞嗞的声音。	n
1.手机待机时间短。 我不知道海尔所谓的超长待机是怎么定义的，作为手机最基本的使用，一般薄电2天左右，厚电也就3天左右，这还是在一般使用的情况下，如果打电话时间比较长，一天就用得差不多了。 而且手机在关机后竟然还在用电。   电池在3－4格电的时候还算能维持些时间，但是到了2格电的时候，电池的续航能力就急剧下降，一般此时打5分钟的电话手机就该关机了。2. 内存真小，用户可用内存只有2M多，我拍照片，拍130万象素的只能拍20张左右，从电脑上下载了铃声，它的每首mp3铃声只能存200k左右，这么小的容量只能唱一句话而已。 最主要的是它不能扩充，真是奇怪的设计。3. 操作复杂。 最下面的导航键盘，每次按的时候都提示退出，还要点击确认，查找多有不便。虽然说查找电话本的方式很多，但是也太不实用了，在找电话的时候，如果用惯了按键的，再用这个触摸屏的真能把人心急。 而且写短信也设计的不合理。 4.浪费钱。 在手机的屏幕上有一个海尔乐园，还不能去掉。不小心按到了的话，它就会拨打12590******的高额收费电话，我有一次不小心按到了，马上挂机，结果一查话费，1.3元已经消费了。真想不通海尔是不是和这些流氓信息台串通一气的啊。 那个gprs功能千万不要用啊，我就只是上了几个简单的网页，一个月就60多元，真是有钱人才用得起啊，不过这和手机没有什么关系。5.送的光盘可以用海尔的数据线，不过针对V8810，它只能将通讯录导入到电脑上，但是无法将短信导入到电脑上，同样的功能为什么不能实现呢？	n
除了缺点	p
这机子算是海尔比较出彩的机子了吧，带手写的机子，样子做的也很有个性，功能方面做的也很出色，其中有个绝密保险箱功能我很欣赏，很好的保护了使用者的隐私，建议以后出的机子都有这一功能	p
摄像头的“准400万像素”和实际情况差别太大，估计不到100万像素；屏幕有时会花屏，扭扭屏幕又好了;电池待电时间一两天，基本不干啥事情；	n
1、价格太贵2、手机表面很容易擦花3、手机信号不稳，常常出现没有信号的现象，而且需要卸下电池再安上后重新开机才行4、别人打过电话来的第一遍常常自动挂断，需要打第二遍才行5、视频有停顿现象6、海尔的服务太差	n
好,史上最好的国产手机!!!支持国货,振兴中华!!!!!	p
缺点太多了：130万像素的摄像头，愣说准400万像素，是插值计算而成（基本上骗人的）。价格太高。劝大家千万不要买。	n
看介绍的功能还挺多的,于是就买了,花了1700.刚用了一个月,但必须说些什么,不然心里太不平衡了.买回来才发现和想象的差太远了,汗.....大头贴不能用拍出来的照片.电池太小了,听上半小时MP3差不多就要用1格电,而且电池还发烫,害得我都不敢听了.电话簿实在烦呀,不管是添加还是查找都很烦琐的,也许是我用它的经验还不够吧...耳机插口不是那种圆形的,只能用海尔的那种,耳机上不好调音量,我用最小音听都觉得声音好大(也许是我个人原因).....滑盖可以左右摇动,不紧,我真怕把滑盖哪天就掉下来了...这机子反应速度有些慢,有时按了键后要过几秒才有反应...闹铃和短信的铃声只可以用手机自带的铃声,不可以用下载的....虽然有PC同步功能,但没配软件和数据线,要自己去找去买- -~   用数据线传上去的图片只支持JPG格式,会动的那些图案一概显示不出来.....虽然是200象素的,但是拍出来效果不好,连颜色有变了,比较暗淡....播放3GP视频时经常就卡了,然后播不出来,我下了大概有10个,在电脑上播是效果都挺好的,传到手机上只有2个能够完整的播出来...还要说一句,不要错买了,它没蓝牙也没红外.....哎....	n
手写输入；通话质量好；外观大方；多功能	p
新电话号码不能直接存入已有姓名里面,必须打开姓名添加,太烦锁，不支持游戏下载,游戏没有新意，机子本身可以实现软件下载,但支持铃声,图片的大小.数量有限制，并且随机配置没有PC同步下载的数据线(机子配的是内存卡的数据线),还需另配,麻烦；对于多功能的此款机子来说,自带电池容量太小,待机时间较短。	n
韩式滑盖设计加手写笔的输入方式，让这款手机拥有最佳的使用舒适度，别小看它附带的那个小巧的手写笔，给我这样对拼音输入法不是太了解的用户提供了又一种输入方式选择，而且它的灵敏度不错，当习惯了手写输入方式后，发短信的速度也会快很多；标配200万像素摄像头的效果还行，外出办公做个留念还是挺不错的；96和弦铃声的效果也够清晰，可以随意把自己喜爱的MP3设置成铃声，可玩性相当高	p
应该在保证质量的前提下，价格适中，先占领市场，让使用者感觉到海尔手机是非常可靠的，就像海尔冰箱一样，这样海尔手机还会没有销路吗？利润还会少吗？在一定的时期让利于消费者不见得就会减少利润，放长线钓大鱼，看看奇瑞汽车，一开始不就是走的让利于消费者，占领市场的战略吗~!	p
1，语音报号，特别在驾车，耳机接听等不便看手机的情况下比较实用。2，拍摄图片效果好，特有的4副照片同画面显示功能。3，声音宏亮悦耳。	p
海尔M260说明书上说，可以有500组电话号码，每组可以包括5个电话号码。实际上，一个姓名下只能存一个号码，或一个电子信箱。也就是说如果你要在一个人名下保存手机、家里电话、公司电话、传真、地址，你必须占用5个电话组的份额，即5/500。非常傻，我今天买的手机，我现在就想卖掉它。非常恶心。	n
刚买的，才一个星期，还没完全熟悉，但是使用过的功能还是非常不错了，各种功能齐备也很好用，这个价格，应该是物超所值了。	p
我需要的功能基本都有了～～	p
黑屏白屏一个接着一个来，明显就是855的再生版，连电脑辨认都是飞利浦855，排线容易坏，外表容易被磨损，电池不经用，寿命也不长，而且还容易花屏，外瓶的质量更不用说了	n
刚买来一个月；就摄像头坏了，没铃声．修了２０多天，拿回来没用１０天；显示屏就坏了，又修了２０多天下午拿回来，第２天早晨屏幕又没显示，气死我了我发誓以后再不买ＰＨＩＬＩＰＳ的手机	n
用了不到一小时（大概有40分钟待机）就死机了，无奈重来，议会又自动关机了，郁闷，可是新买的阿	n
859 厚实的感觉恰好贴合了男性用户对于手机手感的要求。数字键的双色设计在平实的键盘风格中显得尤其特别，但尤其字键之间的联系过于紧密，字键也与机身平面相平衡，由此对手机键盘的操作有所影响。65536色的TFT屏幕，可以显示最多7行中文字符，文字显示清晰锐利，图片的色彩略为偏淡，亮度有提高的空间。除了继续使用T9输入法外，字符输入缓慢的缺点也得以修正，导航键也可以在文本输入中起到作用。	p
1：内屏的显示有时会有迟缓现象；2：在照片的拍摄质量上不是很出色。	n
排线容易断...	n
这款手机不仅拥有130万像素的摄像头，而且还配有TV连接线，可以轻松地在电视上浏览照片和A/V短片，这个功能在一般的主流手机上都是没有的哦，显得非常有特色，俨然一部数码万物，可玩性相当高；内置的触摸屏技术也让这款手机增色不少，使用舒适度一流，让我减少了使用输入法发短信的麻烦，只需屏幕手写即可完成	p
待机时间为是这款手机的最大亮点，40天的超长待机的确吸引人；键盘的手感很好。	p
前段时间买了“飞利浦”S800后，，最初每天几乎不打电话，只发少量短信，只能待机一天多一点，过春节两天发现连一天待机都用不上了，上网看帖子机友们也反映电池问题，但都没我的严重。过了两天找客服要求换机，客服说没问题——换机“未遂”！第二天又去，在我强烈要求下换电池——成功。回来后发现待机问题仍没解决，继续找客服。连续去了三天，最终客服检测说机器漏电，同意换机器。顿时高兴~~~~！但心理也有一些不满，为什么同是一家客服，不同时间检测出的结果会不一样？	n
刚帮朋友买960手机,200万的照像效果令人失望,声音小,手机使用说明欠详(MPT程式中文介面翻译有些词不达意,不能一边听歌一边操作其他功能,蓝牙,红外线连接传送接收文件太小限制,按键迟钝….	n
破手机,烂电池,键盘小,不要买,我已买了960.悔啊	n
外观很漂亮,手感也不错.功能齐全	p
支持SD/MMC卡，可扩充内存是我买他的最大原因；mp3的播放功能还可以，虽然声音没有索爱的W系列大；滑盖手感好，有质感；运行速度还可以，比我以前用的一款moto快多了。	p
买完第2天开始使用，第一个电话通话中，突然死机；重开机，第3个电话通话中，又突然死机；一天中反反复复死机，有时还自动关机！这可是一台有合格证的新机器，真不知是如何通过出厂检测的！目前正在送检中.	n
１．待机时间没的调２．拍照还可以３．外行设计非常酷	p
全身线条流畅，超长待机。	p
人在1.27买的768，那时在本地还没上市我也是通过朋友在飞的内部购机的，至今也有大半年了，对768由喜欢到不是很满意，最后只把它当做一般的手机来使用了。在这里说说它的好处吧：    1、不可否认768的外型确实吸引人，就算我用到大半年了拿出来还是感觉很新颖很时尚    2、在功能方面很易上手，在闹钟和快捷键方面确实很好用，还有屏幕很细腻但是如果在不同的角度看的话就会有点变形的感觉，还可以通过软件制作电子书如果不需要也可以用TXT来转换格式在手机上看，对于玩游戏本人不是很追求所以多数能玩俄罗斯方块就行了。    3、在铃声方面，在室内的话还可以听到在外面就很难听到铃声了，不过可以通过MP3放大器把铃声放大但效果不是很好，如果是常放在腰间的朋友可以按定6键来转为振动。在听MP3方面外放效果不错不过条件是在晚上或在一个小房间里，戴上耳塞效果更好，有时在晚上睡觉的时候可以放些MP3再定个时间让它自动关机这也可以省了电。    4、在待机方面本人感觉很挺满意的，一天20-30分钟通话、5条短、30分钟MP3偶尔拍一些照片、晚上1：20关机7：30开机可以用上6-7天，如果是配电最多5天，本人算过了通话时间是4小时那如果你每天30分钟来算的话7天左右吧，本人的一个群的朋友可以用到9天这个记录我至今没法打破，呵呵！    5、在拍照方面本人感觉满意，比其他130万像素同比级的机子好多了，但是拍照时手不能动，如果你认为你的手抓不稳的话可以分辨率调到800X600再选择连拍效果也很好！可是在单位没有法上传我拍的相片！随便提一下它还可以当摄像头来使用但效果可想而知呵呵	p
机子反映迟钝，太让你失望了，冲着这个牌子的电池呢，结果用不到两天。而且经常死机还有自动关机。原来大家用了都有这个感觉。这个机子应该有设计缺陷。。。。	n
看到对768的好评，我也冲动的买了一个，可是就只是开心了一天都不到。     两块电池都只能用一天，原装电只能坚持一天多，而且是晚上关机，电话三四个（加起来不超过15分钟）,另外一块就更差了，连10个小时都不行，而且是完全静待机。我哭啊，谁说这个手机待机时间长的。    早上找到飞利浦手机维修点，说我的手机没有问题，电池也没有问题，那到底是谁的问题，我才买了一周啊。    不过我也要说一下它的优缺点    优点：手机摄像效果不错，戴耳机听音乐的效果不错，菜单比较明了，手电功能比较方便，随意更改快捷建的功能我很喜欢，就是其中可以选择的项目不够多。	p
铃声开到最大,顺风耳还是听不到!听MP3时就不用提了,太差劲了!	n
1.圆滑弧形设计手感相当好。2.MP3播放效果出色，音质比较优异。3.扩展功能好，支持内存扩充、支持红外、蓝牙功能、USB1.1数据线及免驱动U盘功能。4.电池待机时间长。	p
也买了，感觉不错，手感很好，2280搞定,送蓝牙	p
圆滑的弧形设计手感相当好；MP3播放出色，音质相当优异；内置主流的130万像素摄像头并带有闪光灯；支持内存扩充；支持红外、蓝牙蓝牙功能、USB1.1数据线及免驱动U盘功能；电池待机时间长。	p
主要是深圳产，广东深圳一带的产品最好不要买，我的手机也是自动开关机不定。	n
我买了不到15天就出问题,大老远跑去做鉴定报告,想退吧销售商不同意,只同意换.现在只希望手机不要再出问题了...昨天我发现有个同事也买了这款手机,我刚说和我的一样,她就问:你的手机坏过吗顿时把我惊得合不上嘴...怎么回事啊,原来她的手机经常自动关机-这不新鲜-还经常自动开机,这就新鲜了.她去鉴定处人家还不给她开鉴定报告,说现在没坏呀.她到现在都没退换成.所以,朋友们,千万不能被手机的外表和牌子迷惑呀.以我和同事的亲身体会提醒大家千万别买此款手机了,以免上当.	n
也买了，感觉不错，手感很好，2350搞定，暂时没有什么不爽的，就是不知道是否耐磨！	p
真的很好用～～	p
显示屏达到26万色，图像清晰，而且，外屏也可以取景！铃声十分清脆！比较柔和！内置扬声器也不错，保证了MP3播放时的音质！CCD的摄像头拍照更专业！	p
别的一般！有自动应答功能啊！我不愿接的人我就起动自动应答！特方便	p
1、插笔的地方用不到百年就松动，已经丢了两只笔了2、运行速度慢，经常假死3、电池盖不久不久就变形，现在中间凸着4、中间层掉漆5、键盘是个鸡肋，根本没什么用处	n
电池的使用时间太短了,可以说是很不方便	n
两天就要充电，不知是给的电池有问题还是待机时间太短！以前那个小灵通都没这么烦！机子速度也不快，再加上图形菜单，更慢了！游戏设计得没意思！显示屏不好看，没有朋友那个TFT的鲜艳！	n
一、价格便宜。二、软件虽然凌乱但很丰富，一般的实用功能都有。三、内屏虽然只是CSTN的，但由于是65K的，画面颜色还是挺鲜艳的，可调9级对比度。 四、具有五种情景模式（普通、静音、户外、会议、车内），而且设有快捷键方便快速切换，我觉得这很实用。	p
本人发现了一个很不人性化的地方就是整点报时这个功能，我一般晚上是不关机的，谁知道它报时大半夜也报，任何整点都报，夜里的声音是很大的，这就有些不好了！！！！！还有就是前面的朋友说发短信不方便，不能自动储存自己编辑的短信，但是我觉得很方便啊，在你编辑好你所要发出的短信后，你可以选择发送并保存，这不就可以啦？	n
屏幕显示的色彩比较丰富，支持WAP、GPRS，支持录音和来电防火墙，电池使用时间也比较长！	p
1、  EG860的替代产品，称为东方魅力2，改进了过去手机电池和机身之间缝隙过大的缺点，做工也更为精细，手感也更好。2、屏幕显示比较丰富，支持10行中文显示，每行8字，用户浏览信息更加轻松和方便免去了接收短信后频繁翻页的烦恼，对于短信一族非常合适。3、独具的“来电防火墙”是EG818的主要卖点之一能够有效隔离不必要的骚扰，使用户进入一个全新的宁静空间。	p
MP3内存小，像素低，通话声音小，一句话，质量差，千万别买	n
罄竹难书	n
本身技术不好，4月上市我是11月买的。在保修期就坏了，老是死机。去维修部叫我等15天。结果还是没有修好，拿回来声音有问题，拆东墙补西墙。敷衍我。于是我又去，就这样拖来拖去。过了保修期了。售后技术，效率，服务差。手机本身质量有问题。浪费我1590块，我恨死他了。我的朋友也不敢买这个牌子了。谁来付我的损失。你们还敢买吗？	n
颜色有些失真！	n
我的是730+，9成新，500元谁要，妈的，我受够了，现在发现波导的质量比较好。	n
马马虎虎还可以吧。	p
1.2.1WAP没有2.0版本的效果好！不支持MP3播放！不支持红外接口！	n
听筒音量太小，户外看不清屏幕．内存太小．不支持存储卡．	n
破烂玩意刚从济南国美买了一部,没2天扬声器就爆音厉害,64和炫我也没听出来怎么好,音质奇差劲服务态度还不好哎倒霉啊	n
郑州的东信售后服务很差	n
朋友，很遗憾的告诉大家：我去年四月份从熟人开的手机店买了一架东信EG750，买后一直出现问题，无故死机、无显示、掉话，维修来维修去一共旅游了五趟。龙岩的东信经销商承诺给换机，可春节过后寄去后只是在福州维修部门走了一趟又原机返回，现在连龙岩的东信经销商鬼影都找不到了！你说无奈不？	n
质量次,样子货,买了就上当	n
今天到商店一看，说厂家搞活动，价格也确实挺低的，并且两电两冲，数据线光盘耳机都带	p
听筒声音好小,反应迟顿,连下载照片的驱动程序在网上都找不到,电板也好差劲,用两天就没电了,烂	n
我买了之后就后悔了，价格高：1650.00元。6月第买的，国美家电购，当时连真机也不能看，要付款后才拿到的机子，所以好多功能不能试和了解，只是凭介绍就买了。内存太小，像素没那麽高，每次进入都要设置，相片色彩偏差，来电防火墙设计得不好，谁来过电话也没显示，外表摄像头设计得不理想…后来发现我的手机也不能连拍，但是应该有这功能的，问售后服务点，他们也解释不了。	n
今天逛手机市场,发觉这款价格狂降,就买了,看外观,不错,有咖啡色和兰色两种,(不知还有没有其他颜色)整体统一流线型设计,蛮小巧玲珑的,色彩感觉也还可以,功能较全,只是价格比列出的还要便宜呵呵可能是照顾咱穷人吧呵呵	p
再也不买东信的东西了！我2003年4月买的，一年多了，几乎无法忍受！1、信号特不好，在同一房子里东信没信号，其他的有信号。2、总是在电源充足的情况下自动关机。3、通话质量也很差，通常只听到字的前半个音。4、售后服务不好，我在本地电信局买的。不能换，只负责维修，一修就不知道要几个月。5、不能下铃声，不能下图片，作为一款新出炉的彩屏机真失败，连早几年出来的黑白机都有下载功能。6、电源盖总是盖不紧，容易进灰。7、待机时间太短，我一般是用一天就要换电板。8、背景灯时间太短。9、游戏太少太烂，俄罗斯方块操作设计不方便，玩过的朋友都说烂。10、打电话时如果来短信，仍然是短信原始声音，耳朵不被震聋也会暂时失聪一段时间。11、反应迟钝，看以前的短信要等待几秒，取消拨号也是要等待几秒。	n
我是今年3月1号买的机器，当天买回来的那个的确有死机的情况，后来我去找东信的售后，他们给换了个新的，后来这个用的还好，一直都没有大家所说的死机的情况。	p
缺点嘛，我看也不少。1。信号较弱。2。背景灯时间太短。3。电池不行。4。手机功能操作反应较慢。5。有接电话时按键死机的情况。6。手机密封性能较差。7。随机配件（数据线）不全，部分功能无法使用。8。售后服务不完善。	n
我刚刚买了一部，是彩色的那种，我觉得功能还可以，不过屏幕满大的。	p
我用了两个月，除了时间不太准之外没什么性能上的毛病。我满意的是屏幕的大小和颜色以及自动开关机的功能。	p
通话时噪音比较大，电池使用时间不长，在光线较暗的地方拍摄效果比较差！	n
几乎没有什么功能，连基本的短信群发和MP3没有！	n
键盘用起来不怎么样，功能有点别扭，手感不好，内存也不怎么理想，跟本存不了多少东西！还有，电话本和短信息的存储量也非常小！！！	n
如果单从外形来看，这款机没有什么出色的地方，比较普通。但是看东西不能只看外表，如果看她的里面的功能的话，你就会发现其实这款机的功能还是比较实用的。先说照相机的功能吧。我想这款机最吸引人的就是她的照相功能。具有30万像素的摄像头，可以在照相机——设定里选择照片大小（有三种：160*120，320*240，640*480，一般情况下，我使用的是最小的160*120的，这样可以节省空间。）、拍摄效果（正常，曝光，底片，黑白，怀旧，浮雕，轮廓效果，这几种可供选择。我个人感觉正常效果和怀旧，黑白效果的都不错，其它的就不怎么样了。）、拍摄模式（白天、夜间、室内模式三种，这个功能还是比较实用的。）我当时下定决心买这款机，照相机功能是最吸引我的。图片拍得很清楚，也没有在拍照的时候出现死机的情况。还可以把拍的图片作为来电图片、墙纸和作为彩信发送。其次是信息。这部手机不支持在机内存短信，这是比较不方便的。尤其是对短信比较多的人来说更是无法忍受的。支持几种输入法，可以在手机设定——一般设定里进行设置。我个人选择使用智拼，觉得这个速度快。还有彩信，可以选择增加图片和声音来编写，当然也是可以预览的，编写好以后你就可以了送给对方了。如果你想把自己说的话作为彩信发给对方也是可以的。你可以通过这个途径来录音：信息——彩信——编写——确定——新录音（6）——输入文件名——确定——按OK键录音——确定——储存——播放，这样你就可以听到你刚才所录的内容了，如果你想把他保存的话，就在最后一步里选择“加入多媒体信息”，这样你就可以在我的收藏——影音中心——语音里听到刚才自己所说的话了。你在编写彩信时，想要增加声音的话，这个就可以作为选择了。只是这个录音功能若能再方便点就好了，只要按哪一个快捷键就可以录音的话就更棒了。那样当你灵感来的时候你可以很快的录下自己的杰作。再说一下影音中心。如果你的手机没有上网或者你没有从网站下载图铃，又或者你没有录音的话，你的影音中心是会出现“无资料”这几个字的。我的手机开通了GPRS，可以自由上网下载图片和铃声，我的手机铃声的格式都是MID的，论坛上有人说这款手机支持MMF和WAV格式的铃声，可是我下载的时候却不成功。还有就是图片，我下载图片时也不成功，不知道是哪个环节出错了。按理说应该是可以的。	p
缺点多如牛毛：声音小，屏幕容易进尘，买了半月就去除尘好几次。易死机，待机时间短，短信使用极不方便，输入法不好用，信号接收不好，售后服务奇差。	n
内置的铃声不好听，没有红外线功能，内置游戏在键盘上不好操作，外壳比较粗糙，在日光下彩屏比较难看。	n
1.外形略厚； 2.键盘稍小，手感一般； 3.电话本和短信存储量较少； 4.不支持MMS彩信和短信群发； 5.当新信息容量大于收件箱可储存的剩余容量时，信息有资料遗失状况； 6.铃声音量较小，几乎没有铃声下载地址； 7.电池待机时间短；	n
购了5688+后感到好用，又给女儿购了一个5688也好用啊。	p
这款机子不错,无论从价格还是到性能都很好,我用了一段时间觉得挺好	p
外观和铃声不错，功能也很多。屏幕和键盘都很满意，显的很大方，我喜欢按键偏大一点且稍微外凸，按上去有手感，J6很符合我的口味。而且在130W像素手机中价格比较有竞争力。	p
容易坏！——迪比特手机的通病！这个机子在冬天还怕冷！天冷就没有了铃声~	n
有声音和没声音是一个样子，反正你都听不见	n
续电时间短,一接来电就自动关机	n
震动不知道怎么就坏了，还有屏幕也黑了，还好能听见声音和打出电话。但是和盲人没有什么区别，要凭感觉摁数字，因为看不见来电，只管接。哭啊。	n
我是今年1月1号买的，三天就无声，还不给换（承诺是7天包退，15天包换）商家和售后相互踢皮球，差的把我跑死！过年老没信号，舅舅一打电话老说是关机要么打不通，（我的卡是全球通，基本不关机）掉漆掉的吓死人，铃声和图片说的是可以下载，我找了一个月却一个也下不来（我用的是宽带100M/s),至今我还没发现通话时间可以达到180分钟（最长的是充满电6小时可以打100分钟），待机2天就不错了，按键反应还不如乌龟爬，还没有手机密码和短信密码，没有隐私保证。声音小得要死。	n
可质量为什么这样差，用不到一个月时间，就出问题，还有，反应太慢，掀盖半天了，图像还不显示，还有，用不到一个月，我在打电话的时候就会显示没有网络了，无法连接到服务区。	n
这款机子反应迟钝，好象有点弱智，还有不知道怎么下载图片和铃声。	n
1.操作反映速度慢； 2.屏幕色彩不够清晰； 3.电池待机时间短。	n
虽然有6.5万色的内屏颜色但看起来不是非常清晰！照相功能也一般！不支持MP3和来电防火墙的防“搔扰”功能。	n
1.最大的缺点是外屏的没有显示灯，亮度不能设置。在光线较暗的环境下根本无法看到来电，外屏的字体太小。它的夜光设计好象起不到作用。我觉得这是机子最大的设计失误。2.按键给人感觉实在不爽，太软，反应太慢，很多时候按几次才有反应。3.手机外屏有一盏小小指示灯在电话来电时会闪出不同的颜色，本来这样的设计不错的，但这小灯在待机的时候老是闪个不停，又不能关掉它，也挺耗电，挺烦人的！4.后盖的电池安装虽然比较方便，但总觉得它有点松，缺乏安全感。5.现在彩信这么流行的时代，这机竟然不支持彩信，实在是有点与时代脱轨。6.机子的质量不太稳定。我买了才半年，已经出现过好几次蓝屏和死机的现象，它原装配来的耳机现在已经坏了。7.当手机在电池电量不足时，老是不停地发出警报声，就和三星的机子一样，响到没电自动关机为止，这样实在在烦了。	n
可是买了之后真是有点后悔，我发短信很多的，可是这款手机短信接受比其他手机多了一个程序，简直就象乌龟爬一样。再看看大家的评论，我现在很担心我的手机什么时候就坏掉了。	n
1. 机身不能存短信； 2振机的感觉不明显； 3.电池待机时间短； 4.不能把开关机的声音和接通电话提示声音去掉； 5.按键很硬，手感很差； 6.机身金属漆容易磨掉； 7.没有网站提供铃声下载； 8.没有红外线和蓝牙接口，不支持WAP、GPRS和JAVA功能； 9. 不支持彩信；	n
是彩屏的。而且价钱比较适合学生	p
样式是不错的。	p
外观小巧可爱 银炫直立式手机，最适合时下帅直的年轻姆指族，有话就讲的生活型态，除了有EMS简讯功能，在游戏及萤保动画亦可展现个人的独特风格。 群组管理设定，来电铃声方便辨识区分家人、朋友、同事、重要人物，不同的群组设定不同铃声，麻吉的死党也有专属的铃声! 电池待机时间长，价格便宜！	p
外形可爱，实用性很高，价格也不贵；铃声比较好听，种类多；这款属于纯情天使，听名字就已经很浪漫了；整个机身设计非常简洁；每个键盘与手指的接触面积足够大，增加了舒适感；内设5款游戏，娱乐性比较强；机子硬件性能不错，使用时间长，快2年了没坏过。	p
可是，在八月初因不小心把屏给弄坏了。这下惨了，哪儿也没配件，哪儿哪也修不了。到现在都快一个半月了，还是没配件。	n
D3100缺少DIY功能（没有软件支持，不能直接对手机的电话本、铃声、待机图案等进行操作、设置，所以缺少了很多的乐趣），不支持MMS及EMS,只支持SMS。机身不能进行短消息存储，不支持关机闹钟。设计原因导致显示屏部分地方容易磨损，读取sim卡时间过长导致读取短信速度很慢。还有一个不太起眼的地方就是在安装SIM卡的时候，SIM卡锁很难打开和闭合，或者可以说是需要很大的力气和技巧。令人颇为之费劲。	n
外观很精致，外壳是硬塑的，韧性很好；我最喜欢的还是铃音，尽管是16和弦的，声音很大啊！对了，它的屏幕不是STN的，而是TFT的，效果挺好。别看它小，但功能一点都不少。自动开关机，关机闹钟，短信群发，机身可存100条短信。	p
是一款女士机，很小巧，屏幕颜色很好，而且还有2.5M大容量下载空间。	p
价格有些贵，不能拍照，2400元的手机，只是滑盖用吗？什么手写、JAVA没有！	n
1 机器做工很好，表面还算比较精细。我用的是红色的，挺耀眼的。2 它的功能上是很不错的，因为这部机器是韩国人自己用的，所以在功能上是不敢马虎,比起国内的很多韩国贴牌手机那是好得很（如东信860等）。就像同样是日本手机，海信2101就比三洋550好得多，因为2101有日本原型机c309h，而三洋是对外的。我去年用海信，今年用三洋，现在又在试用用大显。3 这部机器按下右侧的功能键，可以进入联通无限菜单，包括了除了定位之星所有的数据功能，而且反应速度比中兴218快得多（打开彩e邮件的速度中兴很慢）。我下载了一个打地鼠的brew游戏，执行速度很快，很有意思.4 它的铃声是我所见到的最好的，简直比三星的40和弦高一档次，而且推盖合盖都有声响，很炫。5 而且他的功能是比较人性化的。我个人感觉最出色的是数字键导航，还有在待机状态下，每个按键都可以不用闲着，长按短按都有其代表的功能，可以设置。另外，他的硬件配置很踏实，虽然并非是其宣称的64m但我个人觉着有找到了海信手机实在的感觉。	p
由于其屏幕超大，所以可以显示文字信息多达八行，C618在大显手机中也属很棒的机器了，机子运行速度很快，菜单操作也很顺手，尽管您是第一次用也不例外，这可增加了C618的亲和力了。当年诺基亚的滑盖就已经迷倒了许多用户，甚至有的人今天还在留恋那种款式，而C618又一次让广大用户找到了那种感觉高贵，大方，迷人。其短信功能也很方便还可支持群发，而它的输入法也很方便，总体来看C618的功能没有让用户失望。	p
不掉漆	p
不支持MP3.很多功能多没有.我心都碎了.买的不值	n
外观看上去太普通，而且外屏方方正正，没有一点创意和时尚的味道！用了半年多，发现铃声效果还可以，但声音偏小；有几次在街上，当时就没听到来电铃声（后来在未接来电里才发现）！还有，不支持短信群发功能！一千出头的手机，我并不要求它有MP3、手写、红外、蓝牙；可连最基本的数据接收功能都没有！	n
机器还可以，手感也不错，外观有三种可选择：太空银、玫瑰红、宝石蓝，外屏4096色,内屏很大，65536色，亮度足够。	p
功能齐全,价格适中	p
实际上这个机子就是多浦达700的OEM产品,WINDOWS手机系统最高支持65K色,你要个26W色在上面干什么钱多了你去看看一个多浦达700的私货是什么价格,再看看这个机子现在什么价格再来放屁	p
1.机身采用烤漆工艺，很有质感。2.屏幕面积较大，显示效果不错，GX20N使用了夏普独有的CG-Silicon TFT液晶屏，26万发色数，绝无仅有的2.2英寸，240X320分辨率超高分辨率彩屏。3.按键面积较大，手感舒适。4.拍摄效果出色，GX20N采用的是35万象素CCD镜头，最高可以拍摄640X480分辨率的照片。拥有4X数码变焦，微距和连拍功能。除了普通的拍摄之外，GX20N同时支持有声摄像。同时七彩的辅助照明灯也相当炫目。5.支持GPRS、JAVA和红外。6.支持EMS/MMS，可发送超长短消息和进行短消息群发，20条预置短消息，可存储200条短消息。	p
使用几天后，感觉就开始有点不爽了。综其缺点和BUG如下(当然这可能是个别情况)：    1、摄像窗口设置不合理，导置容易磨损。    2、该机没配备光盘软件，用户没法自己下载最新的版本刷机，要用户自己找MP4转化工具，而有好多转化工具不适用于E738!而我目前用的是ImTOO 3GP Video Converter。    3、设置自动关开机后，自动开机后不能识别TF卡，进入TF卡时显示全部内存为0，可用内存为0。 但只要关机再开机又回复正常。    4、手机所有设置有时会自动回复出厂默认值。    5、本人最可恨的是，电话簿有时会自动清空!!!!这种情况在我机出现了两次!!可恨可悔呀，每次我都花了差不多一个小时去输入同学同事的电话。(738没能直接连电脑刷电话簿啊)。	n
外观时尚，软件比较合理，用耳机听音乐音质比较好	p
新机死机白屏经销商不给退换公司不给答复	n
36M超大内存，可作U盘使用。支持MP3歌曲重复（单曲/全部）、随机播放功能，听歌很方便，而且音质不错。	p
具备现在时尚的MP3、照相、还有U盘功能。双屏显示。价位低廉，款式简洁。	p
1.面板设计非常简洁。2.支持MP3铃声，音质还算不错。3.支持U盘模式，在WindowsXP下可以实现免驱动操作，miniUSB的兼容性还挺好，操作方便，快捷。	p
我买了波导m08,才2个月就坏了.而且送去2次维修,一点问题也没有解决.这次又送去,一个多月了,也没有答复.真是太差劲了.	n
待机时间长,屏幕大,观赏起来舒服.	p
待机还挺长，性价比较高	p
正常使用也就三天,达不到说明上写的超长待机时间.照相毕竟是30万像素,效果很一般.铃声有些混浊,尤其是下载的真人真唱,是不是音源的关系呢还有哪位说的屏幕能做镜子,请指教一下,怎么用不知道是否支持java,但本网上说支持,是不是编辑疏忽了!手机按键不舒适而且缝隙大,还有待提高!充电位置没有防尘塞子,很容易进灰尘,还有像摄像`录音这种功能时间太短,可有可无了,不实用!没有耳机插空和换电池要重设时间.编辑短信时反应有些慢!要是带个原厂的座充就好了,售后不好,数据线之类的配件我这根本买不到	n
我花了1500买了个垃圾,1,经常死机2无下载铃声,图片,3只是掉到地上就用不了,没信号,自动关机,修也修不好,4无彩信,总之,垃圾中的垃圾	n
太离谱了，现在什么年代了，都不能下载铃声！我几乎找遍了都不支持！有时还会突然、死机，真是后悔了！	n
缺点竟然比优点还多 ，不能有GPRS 这就不能接受彩信，郁闷，不能下载图片，铃声是能下的，不过只有少数的几首歌曲的格式支持它 ，但是破机才能存5首歌曲，图片就不用说了，根本就下不了 ，用到现在了用的我心都成酸菜缸了~~~~	n
价钱可以，外型不错，铃声挺大！	p
外形不错，声音很大。	p
１、130万像素的摄像头拍摄出的图片比较清晰，用来做PC桌面应该蛮挡的。２、支持存储卡，可以任意扩展存储空间。３、ＭＰ３　ＭＰ４播放效果尚可，可满足在此价位购机者的需求。	p
闹钟不支持周期选择；不支持蓝牙无线传输；录音时间太短。	n
彩屏，和弦，关机后有时钟	p
不能下载、不配置耳机。太厚太重太大。时常死机。短信息书写字数太少，只有一种书写方式。色彩不好。	n
我有一款贝尔B601的小灵通，使用了不到3个月，显示屏就炸了。没摔过的，外面一切完好，没有损伤的。我也不知道原因，也没去维修，我是做业务的，电话多一点，拿过去维修业务就要中断了。本人开始认为要支持民族品牌，用国产的。现在才知道太幼稚了！国产的质量太差了，售后服务也不完善。即使是保修，也是推三阻四的，这是国人的通病！我也不会去维修了。。。忠告：买通信产品还是不要买国产的号，说得天花乱坠也不要相信他，本人是不会再买的了。。。	n
发信息超快！就是联想功能略显逊色，改进之后便是完美！！手感很棒！GPRS功能虽然很好且方便就是太费钱了呵呵！当然和手机是没关系的拉！！我准备再买一个	p
声音太小  屏幕易磨 我的工作环境太吵,基本上就接不到电话,开着震动也不行,常耽误工作,我这机器是别人送的,让我自己买,我还是选诺基亚	n
只能发彩信而不能收到彩信	n
待机时间太短，而且通话质量也不是很不好。	n
内存 过小只有４ＭＢ听歌造成死机！	n
短信输入太差了，电话簿太不合理了，还自动丢失电话号码，反应迟钝，会死机	n
机器反应速度太慢！！	n
1、功能键太挤2、反应迟钝的很3、白天内屏光线太差4、实用欠缺	n
外观太不好了，而且内屏太小了，键盘挨的太紧了，没有座充，太不方便，上当了 	n
1、键盘按键不方便2、反应台迟钝，笔划输入的时候，非常慢。3、拨电话号码时不方便，想在已拨的号码上修改几位数字是不可能的。4、待机时间太短，比他的广告吹的差了十万八千里。还没有座充，非常麻烦	n
漆身不好，放在口袋里时间久了，有掉漆现象！后盖过于严密，不便于拆卸！短信不能自动存入手机，只能自动存入SIM卡之中！拍摄的照片质量一般般！拍摄完毕后，对图片的载入速度比较慢！铃声调至最高，有失真现象！速度不行，短信输入不快！	n
1、 独特的不对称造型，在看来似乎随意的风格中很好的诠释了现代年轻人对美对时尚的观点与需求；2、 可换彩壳设计很好更进一部提升了手机的个性化特征与时尚品位；3、 内置30万像素摄像头，拍照功能十分强大，支持最高7倍的数字变焦，操作性也非常强；4、 内置红外接口，所以可以方便的DIY铃声和待机图片，也可以上传一些视频短片或者Java游戏，娱乐性比较不错；5、 价格合理，性价比极高。	p
待机时间特长，按键手感好，没有翻盖小巧（本人不喜欢翻盖的）, 短信和电话本设计不错. 铃声也不错, 菜单设计简单方便。中文拼音输入，快！整机手感好，外型不错，男女都适用。	p
1.全球首款斜45度外屏设计!具有鲜明的个性和典雅的外观！荣获欧洲设计大奖明星奖的阿尔卡特OT-C651，给年轻朋友更多的选择机会！2.采用了YAMAHA芯片的40和旋铃声，支持MMF、WAV、AMR和MID格式铃声！可根据自己的爱好选择自己喜欢的铃声格式，如果你是一个DIY爱好者的话还可以采用COOLEDITPRO对自己制作的铃声修改音量。从而达到震撼效果！3.阿尔卡特的大部分机子的来电铃声，开关机铃声和短信音闹钟可以共享同一个铃音库，所以C651也不例外！并且采用了556，557上出现过的随机铃声，一旦启用，你永远不会知道下一个来电时响起的旋律是什么！每一次都是一个新惊喜！4.摄像头方面支持30秒有声拍摄，不祥某些机子号称支持拍照摄像但却10秒不到，还没声音哦！C651有情景模式和拍照特效选择，还可以添加相框！5.支持红外，并且具有良好的红外兼容性！并且通过红外就能传输图片、铃声和视频等！同时也摆脱了软件的束缚，随机的软件只是在传输应用程序时才有用武之地！6.永远不会落伍的笔画输入法！甚至数字7和9键上都是笔画，并且具有极强的联想能力！没有用过阿卡的机子是体会不出来得！	p
1、外观时尚，很漂亮，而且还可以更换彩壳。2、按键采用鱼鳞式，排列整齐又不失层次感。按起来也不费劲，可谓是最好用的键盘了！就一个字“爽”！3、铃声功能强大。所有的铃声都可以设置为来电铃声，短信铃声，闹钟铃声，开关机铃声，约会提示音。另外还可以设置翻盖音，按键音。个性十足！	p
优点方面首先设计比较时尚，按键的手感也十分舒适，屏幕显示方面尤其是外屏显示效果非常不错。可以更换彩壳的设计也是在众多翻盖3G手机中不多见的。支持视频片断播放，支持MMS、EMS和SMS，支持Java MIDP 2.0，虽然只配备4.5MB的系统内存，但作为一款中端手机，这样的配备还是可以的了。	p
1.可以轻松更换外壳。2.电池续航能力一般情况下可以达到5天左右，表现比较出色。	p
（1）我不知道在哪里下载铃声，支持VK的网站实在少得可怜；（2）没有短信却群发功能，这对于我呢个短信迷是个死罪来的（3）无固定维修店铺，只是授权**代理，我觉得有点流野的感觉。	n
太多啦,不支持关机闹钟,没有数据线,铃声不好听,又不能下载,图片又垃圾,有个性图案和个性铃声没有数据线也是摆设,说软件升级后支持彩信,我买了一年多了还没有升到,有上当的感觉.还有,自动复制电话本,最近又自动挂机,好头疼啊	n
短信铃声只有一种，很单调！电池不稳定，明明显示充满，可不久又没电了！一旦没电，马上关机，连个提示都没有！和其它牌子相比，这点太没人情味！没有自动开关机功能！显示屏不清晰！拍出照片不行！没有夜拍功能！没有彩信功能！菜单默认为英文，每次都要切换！电话薄太弱，查找联系人只能从上到下地翻看！短信只能存100条！不能录音！	n
原先在VK520有的Java功能，到VK530不见了实在令人有点失望。无声短片玩起来就太没有意思了，而且暂时只提供紅色的，希望选择可以多一点。 	n
电池在使用初期待机时间还不错，但在使用两三个月之后待机时间就大大缩短，手机自身的反映速度也减慢！	n
我的机子莫名其妙的变成哑巴，只有震动，没有铃声、图片、FLSH、照片无法储存，这种现象已出现第三次了，每次都返厂修理。最后一次作为垃圾抛弃。谁要再买着机子简直就是眼瞎了	n
1.与电脑连机又慢又容易死机有时一两小时才传完资料全部搞定实在太耗时.2.MP3播放调音量有时都会干扰播放,播放SD中的MP3更明显,滑盖正常开启和任何按键在MP3正常播放,屏幕进入节电模式后按下,在屏幕变亮同时都回造成MP3播放1-2秒的停顿.3.无蓝牙就算了,红外线只能传电话簿就有点说不过去了,而且能与之互传的只有有限的一两款还会造成对方死机.还不是每次都能接收.4.游戏又无聊又少还很卡没法玩.5.电量经常只有一天就玩完照像费电的要死一播放SD里的MP3电池就火热.6.不支持群发太不方便7.咖啡伴侣图像处不理没区别,简直是骗人的.	n
屏幕比较清析，功能较齐全．	p
塑料壳子易坏(本人的已坏:)电池待机时间从没有超过1天在购买半年后待机时间别想超过半天没有红外就算了数据传输到现在实验过3太电脑就没有一次成功的总说"确认连接"哎放弃ING~	n
产品性能可以,样式也不错,比较好用,发短信,上网都可以	p
爱坏，爱死机	n
1.不具备拍摄视频短片功能，内存有限。2.扩展能力较差，不支持JAVA、红外、蓝牙技术，落伍了哦！	n
今年上半年购机使用后,上述网友们发表的手机问题也是频繁发生。上个月手机短信功能又突然失灵。去指定维修点告知：生产厂家关门，维修点撤销。想修都没有地方去修理，服务态度太差。	n
2006年7月19日我买了VK700手机.可是刚不到一月就出现白频.VK700机醒不错.可质量怎么这么差啊?	n
换了一部小灵通，选的627，还不错，挺漂亮的一部机子，感觉通话质量挺好的也稳定，偶尔有掉线，但是这种情况不多，在外边跑业务，电话费感觉真是省了不少，呵呵，选对了机器	p
用这只手机打电话不能太长时间，如果时间长了，通话音量就会变小，呵呵，这个是新出的智能控制通话时间的功能不？再有，铃声有点小，主包里时就容易听不到了	n
铃声音色不错。显示效果也可以。电话薄500条，平常足够用了，而且支持分组，还可以在联系人项目里添加：四个电话号码、QQ号以及备忘录等。	p
总体感觉不是很实用，屏幕是单色的，电话薄也不好查找联系人，总要一个个地翻着找。而且还不支持短信群发功能。内置的铃声虽然效果说得过去，可是不容易下载，时间长了就听烦了。其它象自动开关机高极点的功能也没有。	n
待机时间没的说，电话多的情况下也能用到6天。信号也不错，怕怕传言中的小灵通，但是实际用起来还行	p
内置无游戏；现在的小灵通基本都内置游戏，哪怕不是精典的，有时也可以打发打发时间时玩玩啊！翻盖不够流畅！按键不大；手感不是很好。	n
1、外观基本上还算美观，手感也还不错，而且是双屏，外屏有三色显示灯，不用打开就可以看清来电号码。2、虽然不是彩屏，而是单色屏幕，但内屏面积很大，分辨率也还过得去，普通的照片显示质量也还能接受。3、电话簿容量比较大，可以存储200个姓名，而且每个姓名可以存储3个电话号码和2个电子邮件地址，这点很实用。短信的收件箱和送件箱容量也还可以。4、它的拒接电话功能很实用，既可以预先设置自动拒接，也可以手动拒接，来电方听到的是电话忙或线路故障之类的提示音，使我既可以不接不想接的电话，而又不伤害来电方，确实挺实用的。5、具有上网功能。其MiMi上网、下载图片铃声等功能都还挺好用的，而且可以随时收发电子邮件；对我而言，更重要的是它的WiWi上网功能，因为我时常在远郊区县出差，有了该功能就可以随时利用笔记本电脑上网，使用起来也很简单，只要用另外购买的小灵猫把笔记本电脑和UT618+连接起来就可以了，至于实际的上网速度，自己感觉比GPRS上网速度还要快些，当然，最大的好处的费用要比GPRS低。6、虽然只是4和弦铃声，但效果还过得去，我下载的仙剑、魂斗罗等铃声效果都还不错，而且由于有电子邮件收发功能，还可以自己制作图片铃声发到邮箱里，再下载到该机里使用。7、在小灵通里性价比还算高。该机在小灵通中属于中高端机型，比它价格高的UT718+等产品除了彩屏和外加摄像头功能外并没有什么实质上的新功能，选择小灵通本来就是把它作为廉价的移动通信和无线上网工具，那些华而不实的功能对我没有什么吸引力，况且自己的GPRS手机就具有那些功能；而比它价格低的机型则功能太简单，特别是没有电脑无线上网的功能。8、待机时间还不错。我的机子使用了一年多，现在如果只是正常通话不使用上网功能，一般都还能待机一星期左右。9、售后服务也还不错，我的机壳摔花过一次，UT斯达康售后服务中心就为我免费更换过。	p
信号不好~！而且可以下铃声~~	n
第一:信号实在太差听筒太小声，听不清楚话筒收音不清功能太少连基本的都没	n
1.客观的说，这个机器的短消息功能比某些 GSM 网络的手机短信功能要强大的多。编辑短消息完成有两个选项：发送和保存，发送之后短消息自动保存在“发件箱”，如果选择保存，短消息内容保存在“草稿箱”里面。 108 的短消息可以在收件箱存储 100 条短消息，发件箱存储 100 条短消息，草稿箱存储 10 条短消息。并可以凭借机器密码一次性全部删除。 2.除了机器本身不带震动外，108 的铃声功能还是可以接受的。3.UT108 为了方便不同使用环境的要求，分别设置了标准，会议，无声，室外和自定义 5 种情景模式。我在用的时候一般在外面的时候使用标准模式，在上课的时候启动无声模式。 4.108 提供不同的闹钟模式，最适合我的就是懒人模式，启动后，在闹钟时间响铃，然后隔 5 分钟再响一次，累计响铃 3 次，象我这样早晨爱睡懒觉的人，这个功能应该是比较实用的了。 5.个人机器可以使用保密设置的机器密码来保护个人资料和机器资料。 108 的好处在于，无论你输入密码错误多少次，都是提示你密码错误直到密码输入正确，不象有些机器三次输入机器密码错误即锁住，需要到 KF 寻求帮助。如果你忘记了自己设置的密码……那也只有 KF 人员能够帮助你了…… 	p
一千出头买的小灵通，是单屏；还不如我们同学价格差不多买的彩屏还是可折叠手机。电话薄没有分组功能！不支持铃声下载!没有关机闹钟！甚至连群发短信功能都没有。价格还不低！	n
上传下载	p
待机长，是彩屏机不能比的。信号还可以。200个机身电话加上卡的450个的电话簿，一般是够用，就是只能储存一个电话是不方便。	p
外形还不错，信号不是很好，比我原来用的斯达康大屏翻盖的那款信号要差。	n
1、UT620作为首款采用方形设计的双屏幕小灵通手机，别具一格的方型机体外壳与贝壳式双屏幕翻盖相结合的设计思路，无疑使自身具备了更大的优势，可以更好的迎合目前时尚人士的要求。2、斯达康 UT620小灵通以银白色和深黑色相搭配作为机身的主体颜色。这样的色彩搭配使得它更加凸现时尚、庄重之势。3、UT620具有七彩来电显示灯功能，用色彩的方式提醒用户，使用户更好的察“颜”观“色”。4、斯达康 UT620小灵通手机支持eZi智能联想输入法，并且具有丰富的中文输入联想功能。5、小灵通手机支持电话本分组功能。200组的联系人存储容量也可以满足一般用户的使用需要。6、UT620小灵通内置多首16和弦铃声，其音质清脆悦耳，婉转动听。7、UT620小灵通手机内置六种闹钟周期。这样的功能设置可以更好的满足用户平时的使用需要。以合理的安排自己的时间。同时它还具有懒人闹钟功能。	p
外观不错，而且手感也很好。26万色TFT，显示效果不错。虽然是130万像素的摄像头，但拍摄出的效果不太让人满意。64和弦的铃声，感觉很不错。	p
这款机子，太拉烂，后悔无话可说．	n
D828的摄像功能做的欠点火候哦，总会卡壳的，尤其是在光线暗的时候录像，反应超慢，光线好的时候好点有限。还有换了个我喜欢的背影图，操作界面也是超慢，这机子反应速度不行啊	n
因为看中了106的外型小巧，做的又精致,所以买了一款回家，但是没想到数据线就是个摆设，根本就不能下东西，到商家那边由专业人员调了半天下没下载下来铃声，我说要换机，但是只换到一根数据线。。。。无奈	n
本机MP3功能较全，音质也不错，各项功能齐全，性价比较为突出。	p
电话薄项目多！支持群组定义！	p
信号好！闹铃中有一星期中具体某几日响铃，很方便了！显示屏在强光下，比以前那个明显清晰！	p
太多了，没法说了，同志们你们千万不要买啊样子还可以，带机不行，电池用一阵子就瓢了还死机内存超小了，天，不说了，还有短信想要看一下得等2年	n
小巧，美观	p
但我用后不足一月才十几天就死机。没法使用。	n
不过，今天发现，网上竟然无法找到铃声，图片下载，哦晕~~~~~~~~~~，同志，能否重视一下还有，今天看好多对tcl的评价，天，我的手机千万不要有问题呀，你们的手机怎么会那么烂，我说的是性能。	n
机子相当薄，也不重，带出去很在面子！机身为白色，而且可以随光照变化。握在手里，很轻很好看！单手可以打开手机，而且十分流畅，做工应该很好！颜色不错，分辨率达到128*160，字体清晰，画面鲜艳！	p
30万像素270度旋转摄像头，在同价位机型中算主流。来电卫士，可减少不必要的骚扰。MOBO物语，教会女士如何自信。菜单为九宫格试，图标明了，容易操作。1.9寸2万色屏幕，颜色亮丽。有快拍键，拍照方便。	p
这款手机的翻盖上的白色真皮装饰相当迷人，并且因为配上了一些暗灰色的线条，使650的美感突现出来，当然，较薄的机身设计与白色的外观色调也起到了调配的作用。此机的机身尺厚度仅有15mm，这在翻盖机中已是相当轻薄的了。手机标配的电池为800mAh锂电，连续通话时间最长可达到250分钟，连续待机时间最长可达到150小时，这个成绩相对来讲还是很不错的。	p
经常无故死机；电池用一天，电话多时用一天不到；与另外的品牌手机相比，接收信号的能力极差，显示满信号、就是收不到，惹来很多朋友的不满；反应速度极慢；根本谈不上售后服务。	n
感觉屏幕小点，屏边上的一圈地方没有充分利用啊。再有彩屏机子耗电量是个问题，用2天就要充电了，没有双电双充盯不住用的	n
不稳定：长时间通话后，不仅机子背后很热，而且再开机后，屏幕颜色开始失真；关机一段时间过后又恢复正常！内置无游戏。内置墙纸少，而且不好看；内置铃声也一样。下载的铃声无法做为短信铃声。数字键用得时间长了，明显感到不够灵敏，输起短信极不方便。	n
1.运行速度挺快。2.手感十分舒适。3.待机时间比较理想。4.机身存储量容量大。	p
1.外壳采用银纳米涂层，具有抗菌功能，还能够阻绝电磁波。2.电池待机时间比较理想。3.屏幕面积较大，显示效果不错。4.拍照功能较强，效果也不错。	p
其一：接挂电话时候机身的红绿键有时候不管用，还是要触摸屏幕才行；其二：没有录音功能，但是通过安装一个软件可以很好的解决这个问题，效果也还凑合。其三：天线太大也太靠边，打电话的时候不可避免的会接触耳朵或头，辐射肯定不小啊！语音效果还是不错的，耳机通话效果多数情况下也不错，就是耳机上的功能键只能用来接挂电话，不象以前用的6230还可以用来激活语音拨号，或者在听收音时候换台、在听音乐时候快进。其四：基本上一直依赖手写输入，按键太小所以在开车时候基本没法发短信了，以前用6230时候可以自如收发复杂的短信息。其五：接听电话结束后，会自动跳出一个询问是否将来电存入电话簿的对话框，很人性化，也可以选择关闭该功能。其六：经历了一次不断重起，是因为一次按了3、4个软件，然后就不断重起，后来硬起加软起才搞定，但是损失了所有数据。这时候就不能不说两个好东西。一个是同步，简单一按纽，所有数据都恢复了，上次同步前的所有数据都回来了。还一个就是backup软件，可以非常方便的备份数据到SD卡里，也同样可以非常简易的恢复手机数据。其七：这一个礼拜充了两次电，第一次用了3、4天，第2次只用了2天，基本上来说还是可以接受的。其八：数字键位置的安排，感觉是按欧洲人手掌大小设计的，反正我用起来感觉如果再向右挪一排就太顺手了。	p
终于换上了可更换的锂电了，先赞一个！！功能依旧强悍，这次的拍照镜头要比600强很多倍，不再是摆设。分色后的字母键更容易区分和辨认。屏幕也更清晰明亮。	p
首先五维导航键的的手感反馈以及方向移动精确度都非常好，其次虽然键盘不大，但是手感非常舒适，定位也很准确，最后就是功能够强大。	p
小灵通的话费便宜，可信号很有依赖性，在我家阳台上能接到也能打，可到了卧室就不行了！很不方便！而且这个小灵通本身信号不是很好，有时通话时有杂音；有时会自动断线！而且800多元也没配跟数据线，要买的话，也不方便；客服说没有这个型号的！要是从厂商那里寄，连来回邮费需要二百多元！按键有些不好用，有些偏软，输起短信时，手指的力度需要一段时间的把握！翻盖也不是很好，不够流畅，感觉有些涩！还有就是电话薄或者短信存储比较多时，机子反应相当慢！	n
1.通话时有些回音。2.外觀設計并无新意。3.反应速度太慢。4.摄像功能像个花花枕头，不实用，拍的时候有水波纹的那种变形并且变形挺严重！5.价位有点高。	n
1.外形设计相当有个性。2.支持RS-MMC扩展。3.手感良好。4.最大卖点：双喇叭设计与3D环绕立体声配置,音效效果酷似专业级音源。	p
1、外形设计非常美观，重量很轻，个头是属于那种男女都适合的类型，拿在手里手感很好。2、机身两侧喇叭，确实很特别，象两个“大大”的音箱，这也是 363自认为设计独到而值得炫耀的设计，感觉真有那么一点听音响“振撼”的感觉，以这种铃声，即便在很嘈杂的环境中，应该也能听到。3、键盘采用的是塑料按键，但还是比较好用。键盘背景灯是蓝色的，光线很强。4、拥有1000* 5项的大容量电话本，短信可以储存1000条短信，储量还是非常大的，完全满足我的需要。	p
电池不耐用，才买不久就出现这样的问题！性能太差阿~~	n
电池太差,买后6天就不能充电,经经销商的专门检查部门检测后说没事,他们给"激活"了,可冲了一次电后又不能冲电,现在还待修,也不给"保退,保换",惨呀!!有高招的能人给指点出路,谢谢。 	n
1、OK210手机机体表面以经典的银白色与具有神秘特点的黑色有机相结合，配合外壳烤漆工艺的加工，使得整机外表的金属光泽更加强烈。2、OK210手机在数字按键的设计方面并没有采用过多的创新元素，但是简洁的设计适度的排列以及键与键之间合适的距离却显示出OK210手机所具有的简约、自然之美，同时这样的设计也可以有效的避免按错键现象的发生。而且各个按键都采用了镀膜的技术。3、OK210两侧采用了上厚下窄的设计思路，更好的展现出了这款手机机身的曲线之美。4、手机支持名片式电话簿管理功能以及联系人电话号码分组管理功能，同时在联系人电话号码复制与删除功能方面OK210确实表现出其优势所在，OK210具有逐个删除（复制）、全部删除（复制）、分类删除（复制）三种方式。用户可以更加便捷的管理OK210手机的电话簿功能。5、OK210手机具有来电警卫功能类，利用这项功能用户就可以将自己平时不愿意接到的来电“拒之门外”，以避免骚扰。而且该项功能操作较为简便，易于广大用户掌握。6、OK210设有30万像素的摄像头。具有静态景物的拍照功能同时手机支持拍摄标准模式和夜间模式两种，提供了相关的照片品质、镜像、快门音效等参数的设置功能供用户选择。7、OK210手机内建15首40和弦铃声，听觉效果出色，高音、底音区分明显，具有较为强烈的动感，节奏感极强。而且当手机音量调节到最大程度是也基本上没有爆音现象发生。8、这款手机支持GPRS无线上网下载功能铃声和图片功能，OK210手机内存采用了弹性管理方式，下载图片、铃声的数量是要根据实际内存量而定的，最多时用户可以下载并存储20组不同图片、20手铃音。	p
屏幕细腻，铃声音量大；操作简单，功能易上手；支持带保修的软件升级。	p
我觉的不错，线上做的不错，几乎没坏的，测试也没坏的，	p
产品质量狠差，性能不稳定，经常死机，速度狠慢，信号差，外表易磨损，有时候不能拍照，不能摄像，突然振动，并且维修服务差，	n
优点就不用说了， ....	p
通话质量很差，很容易自动关机	n
从外形和颜色上判断N6203应该列为男性手写PDA手机，不过，在继N6201之后推出的N6203，功能和硬件都没有丝毫的变化，感觉有点遗憾。	n
1.精致小巧。2.键盘设计整体表现干净利落整洁。3.影像拍摄清晰细腻。4.内置颇具人性化设计之“化身”程序，可对不同联系人进行设置，这点极具创意。	p
我于十五天前买了NEC的6203手机，第一天就感觉接通效果很差，信号显示满格，但呼入却提示对方无法接通，打十个电话有三个不能正常接通，在同一个地方换用别的品牌手机却没有这种现像，所以一定不是网的问题，找到NEC特约授维修单位进行检测，检测却告知手机一切正常，我提出更换却被拒绝了，原因是没有质量问题，唉	n
便宜，比别的同样外观的贱多了	p
1.不显示短信数据统计，比如收件箱有多少，发件多少，草稿又又多少。2.查看短信时，不能直接上翻查看前一条、后翻查看后一条，必须跳出来一条一条看。3.默认的常用短句都是些废话，根本没用，还不能删，还放在最前面。4.输入法顺序是固定的，不可以调整优先顺序，每次默认都是“手写”优先；而且很多时候不能完全实现手写，有时要腾出手用键盘配合（比如标点符号的输入就必须用手按＃键去调用标点）。5.同一个标点符号居然有全角和半角两种，全角多占一格，根本就没用，不解...6.超小内存（实际空间1.7mb）导致拍照和录像空间都很不足。而且，这年头居然还用无声录像，才15秒，不知NEC怎么个定位消费的，起初高达三四千元呢？！幸好降价了...7.不够智能，只要退出拍摄功能重新进入，所有的上次设置参数都恢复默认，所以每次拍照都要设置半天，很麻烦。8.NEC内置的铃声都很弱智，数量又少；也是被玩家骂遍了的缺少MP3铃声的问题，我个人对这方面没什么要求——我向来不大关心过于炫的功能。	n
内屏颗粒感较重，不细腻，内存较小，虽然支持视频播放但无法存储大量视频，电话本功能操作繁琐，到现在我都不会使用，通话声音不清晰，噪音感较重，外壳容易磨花	n
1.屏幕效果一般。2.内存不足。3.价位有点不合理。4.待机时间没有网上写的长，来电提示音不大。5.电量不足时报警太频繁、烦人得很。	n
感觉样子还可以，就是机身有点厚拿在手上有点重.前端的面板设计的挺漂亮的，是铝合金的很有质感，只是红色的LOGO是个败笔，内屏看起来有点小，但是颜色做的不错	p
电池问题：N8是彩色双屏手机，它的待机时间当然不可能很长，一般有2-3天吧。照相功能：恐怕不敢恭维，对光度的要求很高，而且照的相比较小，模糊。此外，有个朋友提到，N8换个屏幕要1000多块，好象很贵。有一次我到三星的专修店修手机，恰好有一个人要换屏幕，报价是1600元！！！而那个手机我记得当时的价格是3500～4000左右。	n
买了10天,死机3次,数据倒不曾丢失	n
1.显示效果方面：屏幕色彩显示艳丽，色彩的过渡自然真实，色彩层次感表现的很好，就是在户外光线比较强烈的环境下屏幕也挺清晰细腻。2.特色方面：TTS功能的运用，当按下N940的侧键时，就可以享受到使用语音对短信息等文字项目进行人声阅读，其阅读效果也十分出色此点可谓方便之极。3.操作速度比较理想。	p
喜欢折叠手机的我对这款手机情有独钟，简洁的外观设计非常符合当代年轻人的口味，给携带增添了一份愉悦；内置30万像素摄像头虽然自己很少用到，但不错的拍摄效果还是适合外出游玩作个留念的；另外它的40和弦铃声效果挺清脆的，就算再繁杂的环境也可以听清来电，让我也不会错过任何来电；支持丰富的JAVA程序，让我可以随时下载程序，秀出自己的个性来	p
1.触摸屏操作快捷,精准。2.对手写连笔字的识别率挺高的。3.拍摄影响方面画面十分流畅。	p
一直都知道LG-C960拥有目前手机业界中的较高像素，其突出想象的外形设计令人匪夷所思.虽然迫于经济原因不能"一机在手",但借用朋友爱机细细品玩几天后,也有大概的了解.1.突出想象的外形设计令人匪夷所思。拿在手里,第一印象就是“金属味道”十足。机身正面镶嵌于深黑色的面板中，而侧面及相机面全部由金属质感的外壳包裹，大气中散发着时尚的气息，就好比是近现代工业和当代科技的完美集合体一样，确实很能带来面子效应。 2.音乐播放软件与我们电脑上的Winamp颇有几分相象,拥有三种播放画面，支持四种循环模式,面板非常绚丽，也很亲切，不过功能却要简单了很多,操作起来感觉却很方便.3.按键设计别具一格。机身左侧设置了不少功能快捷键，有日程管理、MP3播放、文书管理等功能,最为明显的导航键被安排在了数字键的右边，倒是挺另类的创意,而负责删除/返回功能的C键被独立出来。在长时间使用中,感觉键程比较理想，手感也很舒适.4.LG对于CDMA领域内的手机似乎一向都是比较大方，这次C960装备了两块3.7V 1000mAh锂离子电池的配置。能维持2天2夜的待机时间。要知道这款手机由多种“电老虎”元件组成,其电池强大的供电能力,在目前所有手机里面完全是首屈一指.5.拍摄菜单中的功能选项可谓巨细无遗，连专业数码相机所拥有的白平衡，ISO感光度都有,而硬件方面,内置了500万像素的CCD摄像头，支持全屏取景。同时LG特地将补光灯与镁光灯区隔开来，使得照相质量大大地提升。近拍时，可开启镁光灯；遇到光线不足时，也能开补光灯便能帮你解决困扰。 6.支持MP3格式的音乐文件播放，拥有一个外置扬声器，铃音效果非常好,原配耳机保持了在降噪方面优秀的表现。对不同压缩比的MP3音乐文件兼容性都还不错，同时也可以感受到音质的提升。其高音甜、中音准、低音沉的表现让我们对C960使用MP3硬解码芯片深信不疑.7.内建2款3D游戏：方程式赛车跟高尔夫球，不仅画面立体逼真，游戏进行中还会有像Sony PS2一样的手把振动效果，非常刺激。 8.内置了词汇量丰富的“金山词霸”，支持英汉、汉英双向查询是它最令人满意之处。不知LG公司打算何时让自己旗下的GSM手机也具备次功能。	p
拥有象数码相机-500万像素CCD的高清晰摄像头,自动对焦，确保画面清晰锐利；LGC960是一部真正数码相机手机。还可以直播、点播、下载多种模式，真正的在手机上看电视。26万色TFT、2.0英寸精显屏幕;实用的免提功能设计，解放你的双手72和弦，清晰悦耳，余音绕梁，颠覆双耳的音效，非常的舒服。	p
这么贵，买个手机，不知他是如何想的。外观也不好看，笨笨的，他却说可爱。也太复杂了，什么下载铃声，这么多电话薄，他到底用得上不？可能就是看见气派，充个面子吧：_	n
圆滑的机身设计非常时尚；电池续航能力较强；提供与PC版QQ近乎一致的操作界面。	p
性能太一般,价格太高	n
总的来说还不错	p
最有特点的就是它的30万CCD摄像头了，在手机里绝对是高端配置，效果相当不错；26万色的TFT屏幕，无论是颜色的过渡还是字体的显示都非常出色；“超大铃选择”这个功能很实用，大铃声在户外也能轻易听到；大号的屏幕可以同时显示9行中文文字，实用性非常强	p
除了以下说的缺点，其它本人非常满意，特别是它的分项保密功能，非常方便、实用！	p
使用拼音输入短信时，明显有延时！内屏的亮度不可调！短信铃声只有10种，不支持下载的铃声！连接网络后，闪光灯会一直闪，浪费电池资源！内置铃声不好听！设置里没有拒用其它UIM卡的选项！来电接听方式只有三种，略显单调！	n
来电大头贴很时尚,而且,C610还支持“人物肖像”功能,类似于现在非常流行的QQ秀，所不同的是你给大家穿衣戴帽,而且免费！很有意思.屏幕很大,可同时显示9行中文信息，字体清晰、细腻。墙纸不论是鲜艳的“大红大紫”，还是清爽的“小绿小蓝”，都很清晰,C610的显示屏绝对强.	p
（1）外屏非彩屏，内屏的分辨率128*160偏低。（2）内存小，处理器的速度慢。（3）图像解码速度慢。（4）使用拼音输入短信（同时打开键盘声音）时，滞后明显。（5）不支持录音。（6）不支持关机闹铃,不爽!!（7）配置较低：单电单充，无数据线和光盘。（8）背景灯和闪光灯的省电设计欠佳，闪光灯，连接网络时会闪，费电。（9）内屏的亮度不可调。（10）没有支持JAVA，BREW收费的太多了，而且BREW认卡。（11）30WCCD的效果和30WCOMS的西门子CX65成像效果一样，我看不出来。（12）短信铃声只有10种，不能设成别的。（13）自带铃不可删，我没用过自带铃音。（14）设置里没有拒用其它UIM卡的选项。（15）来电接听方式，只有三种。（16）接上耳机后，各种提示音（包括翻盖，按键，菜单，弹出菜单），无法关闭。	n
1.不支持JAVA、蓝牙、红外 2.电池待机时间稍短3。只能发单条短信，有话想多说还要分条发，郁闷！4。打字有点慢，输入快了容易丢笔画	n
1、C610手机采用了流行的流线型的设计理念，整机线条流畅。边角过度均匀而且圆润，这样的设计将韩国手机独特的工艺水平体现的淋漓尽致。2、LG C610手机采用了银色和红色进行机体色彩搭配，颜色搭配协调。配以87.6×46.5×23.5mm 的体积和97克的体重的机身，使得这款手机显得异常出色，时尚气息十足。3、LG C610 CDMA手机配有一个30万像素的CCD摄像头，具有拍照和短片摄录功能。内置高亮度闪光灯。同时还支持7种拍摄效果，3中画面质量选择，多种分辨率拍摄等功能。 4、C610具有26万色TFT材质的彩色屏幕，分辨率达到了128×160像素，屏幕的色彩表现力、色彩的层次感很出色，且屏幕色彩的过度、还原度以及屏幕的亮度、饱和度也都是非常的出色。5、这款手机具有1000组联系人电话号码存储容量，同时支持电话簿名片式管理、电话簿群组功能。6、独特的3D形象秀是LG C610手机中的一个特色，利用这项功能用户就可以设计出逼真的联系人卡通肖像，操作方法简单、便捷，易于用户掌握。7、LG C610手机支持99个快捷键拨号功能，这项功能还是十分的实用的。8、C610手机支持按姓名查找、按号码查找以及按群组查找，这样丰富的电话簿查找功能，可以帮助用户快速、准确的查找到自己想要得到的联系人电话号码。9、C610手机支持20个短信息联系人群发功能，配合这款手机丰富的短信息输入联想功能，用户就可以快速的编辑并发送短信息内容了。这样可以节省用户的宝贵时间。10、LG C610 CDMA手机支持40和弦手机铃声功能。铃声效果清脆、动听。赋有层次感和穿透性，即使当手机铃声音量调节过高时，也不会出现爆音现象，这点还是十分的令人满意的。	p
时尚的外观,功能也还可以	p
待机时间短，一天用一块、二块电池，如果你生意烦忙，好啦，再买个电池包。	n
屏幕分辨率高，色彩艳丽；镜头可进行180度旋转拍摄；独立扬声器效果不俗；加入了蓝牙无线模块。	p
根本就没法用。基本属于外在很漂亮，内在什么都不是，要是lg的手机os工程师加把劲应该是很不错的机子，除非自己有能力刷rom,否则就算了	n
短信容量2000条，强！	p
电池不耐用，每天都需要充电！	n
内外屏显示效果太垃圾，特别是内屏闪的厉害。颜色失真。（我的这样）	n
手机屏幕亮度好。6万5千色的TFT屏幕还是比较细腻，基本没有颗粒感。此款手机又设计为一定时间后屏幕变暗，而不是黑屏。键盘设计个人比较喜欢，蓝色包着键盘数字，很是漂亮。功能区设计为半圆形，美观、大方且方便使用。手机铃声较大，不会漏接电话，且支持人声；通话音量大，嘈杂的地方也能听清；录音有选项，可将录音作为来电铃声，比较个性化。闹铃可设置两组，对于我这种需要早晨、中午叫的人刚合适。电话簿可按姓名、号码、位置、分组进行查询，比较方便，手机与卡之间可相互复制。通话中有一选项，可记载电话号码，做简单的数字记录。手机可存储短信40条，卡15条，可互相转存。短信量不太大的用户基本够用了。 31万象素的摄像头可180度旋转，10倍变焦，10级亮度。拍照没有后滞现象。功能较全，除掌中宽带，联通业务全部支持，包括定位之星。图片可显示的格式有：png,bmp,wbmp,gif,jpeg。可设为背景的图片格式有：bmp,png,jpeg，可设为休眠、来电、开、关机时的画面；铃声的格式有：qcp（语音）,mid,mmf.	p
A100的内存太小。电池不好用。待机时间短，一过包换期就坏，电压不稳，像素给本没200万好模糊啊，授后服务不好。在洛阳买的手机只要一买在早他好像要打仗一样。常自动关机和死机现象。只能说句买了CECTA100倒霉，给本没授后服务。果冻QQ396276755	n
全屏手写功能，屏幕效果好，内置MP3播放功能，音质不错，支持外接存储卡，200万像素拍摄能力比较强、支持通信防火墙。	p
外形很酷，再配上黑色很有个性，可以播MP3，可手写，发短信很方便，64和弦铃声很好听，功能也比较全面	p
机身为黑银色搭配的，典雅高贵！有个MP3快捷键，听音乐很方便！有补光灯，方便夜拍！还有自拍镜，可以打扮打扮自己时用！屏幕效果好，色彩清晰！A100的铃声清晰，比较宏亮！音频播放器的界面和功能与windowsmedia相似，用惯后者操作更快了！	p
排线很容易坏，我买了不到2个月就出问题了	n
电池问题严重。随机带的2块电池，一个莫名其妙的就掉了一个爪，无法接触。坐充接触不好，每次充电要压上一块砖头。刚买了一年，现在彻底废了，无法开机，去维修部，说电池问题，换了一块，充了一次电，又无法开机了。	n
反应十分缓慢，用了不到8个月，坏了5次了，现在还在修理！	n
感觉T700不是很好用，目前用了已快三个月，问题不断出现，先是感觉这机子反应有点慢，尤其是发彩信，急死谁，然后就是黑屏，如果操作快了点，先是反应不过来，然后就自动关机了，再然后自动关机越来越多，不明白，我一直好好使用，只是短信多了些，如果不打电话就是发短信，这不是手机应该是有功能吗？目前已经返厂，唉	n
好搞笑哦，这机子插上耳机后说话声音还是能从手机喇叭发出来，开始以为是机子坏了，跑了几个坛子，居然大家都有这个情况，设计有问题，照像效果还行，但是内存太小，存不了几张，还不能用外扩卡，再好的效果我们这些真用机子的也只能对机兴叹了，再有手写笔超不好用，要用捏的，是我手太大了吗？	n
配件齐全。照片效果不错，而且有自拍、闪光灯性能。手机的一般性能也行了，象信号，铃声都能接受。	p
开关机声音不能取消，且自带声音巨难听，电池太一般了，摄像头绝对的骗人,说200万像素,我看20万都到不了	n
这机子猛一看有点像NOKIA的7610，呵呵，对角对称的设计挺有意思。我选了部黑色的，感觉很有个性。一般机子都只注重正面设计，背面都忽略了，这只机子的背面我就超喜欢，黑底色，银线的几何图案特别显眼。光凭这样子，我就喜欢的不得了，呵呵。	p
这机子外边的透明窗设计的不错，不用翻盖看时间，对屏也是个保护，还省了一个屏，这样也省电不少，银子也一起省了，触摸屏感觉不错，总算不用按来按去发短信了，只是还没用熟，感觉错字多了点，铃声一般，内存小了点，能下游戏我很开心	p
1、速度太慢了些，一般要过一会有机子才会对刚刚的操作有反映。2、屏幕经常黑屏，用着好好的，自己就黑了3、返修好慢哦，我机子送去一个月了，电话过去，KF说还要再等等	n
1,外观，还可以！比较好看2,屏幕，在阳光下不好看清楚！在其他的地方还是很好的！当然没有TFT的屏幕好，但是价格在950，就可以了3,基本没有什么bug。有的时候电话薄上的有一个人的名字，但是按决定不能进入，但是也删出不掉。需要你全部复制到SIM 卡上，在复制回话机	p
外观时尚，机身设计有七彩灯，无须再为挑手机饰品费神、费钱。手写识别能力高（这个价格支持手写功能已经是很难得了）而且支持GPRS。铃声音量较大，最吸引人的是价格低廉。	p
今年七月二十一号在958 598买的机子,不到一星期,就出毛病了,不显示电池电量,八月七号拿去修,说是主板坏了,并且维修站没有主板换,不知道什么时侯厂家能寄主板来,要求换一台,说过了十五天包换期.气死人了.难怪国产手机厂家那么或亏损、或到闭。我看CECT 的命运也好不到那里去。	n
外型适合年轻人,漂亮;铃声大,效果也好	p
反应慢的像猪,彩信容量小,上网速度慢	n
机子小小巧巧很精致!可以播MP3，音质还可以。铃声也挺大的	p
唉，相中这机子就是因为功能简单，想着功能简单就不容易出问题，没想到铃声又有问题了，一会声大一会声小，来电话时响铃，中间还会断一下，接着再响，想想都搞笑，现在送修去了，KF小姐听到我的说明后，满脸茫然，只记得一句话，这个我们也解释不了，要检测一下	n
键盘材料太差，手感也不是很好。电池容量太小，待机时间不算长。最主要的是相机的闪光灯和自拍镜容易被磨花。笨球的设计思想真是太欠缺了。	n
1.如此大的内存竟然不支持JAR2.不支持摄像功能	n
屏幕较差，拍照也很粗糙。	n
元旦拿到了这款机子，在充了一夜的电，用了1天后，越来越发觉了这款机子的一些优越性能，在此简单地谈谈我的感受。1，虽然是4096色屏幕，但是显示效果让人眼睛一亮，基本没有什么颗粒感，而128x160的分辨率，更是保证了细腻的显示2，16和弦铃声，清脆悦耳，感觉完全可以与国内的40和弦相媲美，10种不同国家不同风格的铃声，更是堪称经典3，菜单简洁明了，操作方便。有图形菜单和文字菜单两种显示方式，而且还有12项快捷键供用户方便操作4，其他的一些辅助功能多、全，而且强大，比较典型的就是来电礼貌拒听，还有外屏的日历显示也很有特点。	p
做工不错！按键的手感比较舒服！显示屏的色彩柔和，画面清晰！声控拨号的识别率挺高！支持时下流行的JAVA功能！电话本比较方便查询，按数字键，就会出现相应的联系人信息！	p
买了不到一个月 一个下午就死了4次机 我要摔了它 通话声音小 外界有一点噪音 就听不清楚拼音操作麻烦 整机反应慢	n
按键太小，是男人就按不到或一下按几个。电池性能不佳，这也是国货的通病。功能单一，接口不够齐全。	n
外观没有轻薄型的那种轻巧。有死机现象，需要关机再开机重启;有时时间还有重新调。按键不好用，每次输起短信来，感觉不如以前那个手机灵敏。不支持彩信！铃声不够逼真！使用导航键进行功能切换时，明显感到反应速度慢！查找联系人不方便，一页页地翻，累	n
待机时间短，有时还会死机，手机键盘也不灵。	n
太喜欢BENQ的样子了！！所以马上买下！BENQ由于还没取得在大陆销售手机的许可，所以由CECT来组装/销售的，不过还是BENQ的技术！！觉得很不错！！只是大陆的价格太高了，台北的朋友告诉，这款现在台湾只卖，折合人民币1400...	p
我只能告诉大家杭州这边的报价一般在1500左右，标配是两电两充带耳机，样子绝对是很漂亮。	p
M100不错的机子,整体设计简洁,直板机只有一个屏,所以省是不用说的了,6万5千色的屏,差不多占了机子一半的空间,看着很舒服,不用再盯着小屏了,颜色漂亮,色泽饱满,显示也很清晰,铃声虽然只有16和旋,但是音质很好,还有就是这个机子支持GPRS及WAP上网功能,呵呵,方便	p
功能单一。铃声和单声差不多，谈不上音色的逼真。屏幕显小，和现在很普通的手机比较都显小，不够时尚;而且，样子也不够酷，灰得没有个性。设计也不合理，电池有时感到有些松动，生怕掉出来。翻盖不够十分流畅，没有那种特别清脆特别有感觉的印象。功能少得可怜：MP3、JAVA、手写、蓝牙等都没。拍照效果也太差！！	n
这款手机的屏幕效果特别好,明基是做显示器和液晶面板的,以前的M300就不错的呀，现在这个颜色看起来比M300要好很多的哦~~鲜亮！！！M350的免提通话功能也试过了,效果值得表扬,没想到哦，呵呵~~~20几平米的会议室内,可以用这个电话当作会议电话来使用	p
350的方向键有灯光，在白机上特别明显，黑机亮度不够。摄像头这边都什么年头了，还出11W的。。。虽然效果不差，但是在不同环境下表现效果相差太大，要拍出看起来舒服的照片不得不到日光充足的环境下去拍摄，才能得到比较好的还原最关键的是屏幕，太小了！人家176*220都是主流了，明基还停留在2年前的128*128的标准。JAVA提供的程序太少，和其它JAVA兼容性低，运行速度慢	n
屏幕有点小,市场同价位都是TFT屏且相素在20万以上	n
1.书写功能方面：有很多像SonyEricsson的手写部分都会把用户局限在一个很小的区域内，或者专门有一个很小的书写屏独立于显示屏之外。但这种设计却给用户带来了很大的不便，书写时感觉受到的束缚太多，输入速度也慢，但P30突破了这一限制，成功的实现了全屏书写的功能，我们可以在P30超大的屏幕上任意挥洒。2.语音识别方面：首先要说的是语音识别大体有两种：一种是你事先在手机里边录制好，然后下次再说同样的字，手机根据两次说话音调的变化来判断你所要执行的命令。但这并不是真正的语音识别。因为一旦你喉咙不舒服，说话不像上次那样的音调，手机便无法识别，任你喊的喉咙破了也无济于事。另一种便是真正的语音识别。它不需要用户事先录制自己的声音，而是根据声音的波动来判断用户的命令，并且，和前边一种比起来，第二种对声音的识别率更高、执行命令也更准确。用户只需要像平常说话一样，手机便能判断出用户的命令。P30正是采用了后一种。因此，用户可以藉此真正实现用语言来操控手机。	p
1.按键面积偏小，手感一般。2.不支持视频短片的拍摄。3.电池待机时间不理想。4.不支持红外和蓝牙。	n
我的明基Z2的miniSD卡一关机就认不到，要重新插过才认得到，现在连手机的内存都认不到啦，存在手机上的mp3跟音乐都找不到，555~~~mp3也不能用,但电话本和信息又正常.我买了还不到一个月才，是我点太背了吗？唉~~	n
用这只机子很舒服，信号方面不错，机子运行也稳定，通话是声音比较清楚，室外我也试过，听着没问题。摄像头虽然只有30W，但是拍点小东西也效果还行。	p
机子不大不小，我用很合适；外屏幕小了点，但是看来电号码还是够用，很方便；自动开关机功能我很喜欢，很实用的功能；这机子的反应速度也不错；总体说不错	p
电话本和短信息储存量太小，摄像头易磨损，机身容易弄脏；拍摄效果一般；屏幕文本显示效果一般； 手机的按键最不经用了，我已经在二个月里去经销商那里更换了三次手机了，现在这手机又不行了。拿到二手市场买了750元，哎。。。不信我的话，你就去买咯。	n
P50用着感觉不错。手写功能方便输入及操作手机各个功能，蓝牙红外数据传输很方便。	p
